state,state_po,county_name,fips,totalvotes2020,democrat2020,republican2020,twoparty2020,gop_pct2020,dem_pct2020,totalvotes2016,democrat2016,republican2016,twoparty2016,gop_pct2016,dem_pct2016,pct_change_gop,pct_change_dem
ALABAMA,AL,AUTAUGA,01001,27770,7503,19838,27341,72.5576972312644,27.442302768735598,24973,5936,18172,24108,75.37746806039489,24.62253193960511,-3.740867001358017,11.451993791893166
ALABAMA,AL,BALDWIN,01003,109679,24578,83544,108122,77.26827102717301,22.731728972826993,95215,18458,72883,91341,79.79220722348124,20.207792776518758,-3.163136206069861,12.489915272889295
ALABAMA,AL,BARBOUR,01005,10518,4816,5622,10438,53.860892891358496,46.139107108641504,10469,4871,5454,10325,52.823244552058114,47.176755447941886,1.9643782734280357,-2.1994906802045633
ALABAMA,AL,BIBB,01007,9595,1986,7525,9511,79.1189149405951,20.8810850594049,8819,1874,6738,8612,78.23966558290758,21.76033441709243,1.1237897697246924,-4.040605906299366
ALABAMA,AL,BLOUNT,01009,27588,2640,24711,27351,90.34770209498738,9.652297905012613,25588,2156,22859,25015,91.38117129722167,8.618828702778332,-1.1309432649674434,11.99083121237965
ALABAMA,AL,BULLOCK,01011,4613,3446,1146,4592,24.95644599303136,75.04355400696865,4710,3530,1140,4670,24.411134903640257,75.58886509635974,2.233862094260042,-0.7214172202426039
ALABAMA,AL,BUTLER,01013,9488,3965,5458,9423,57.922105486575404,42.077894513424596,8732,3726,4901,8627,56.81001506896951,43.18998493103049,1.9575605045268452,-2.574880309362859
ALABAMA,AL,CALHOUN,01015,50983,15216,35101,50317,69.75972335393604,30.240276646063954,47864,13242,32865,46107,71.27984904678249,28.720150953217516,-2.13261631888243,5.2928889382321875
ALABAMA,AL,CHAMBERS,01017,15284,6365,8753,15118,57.89787008863606,42.10212991136394,13900,5784,7843,13627,57.554854333308874,42.445145666691126,0.5959805811352359,-0.8081389519093318
ALABAMA,AL,CHEROKEE,01019,12301,1624,10583,12207,86.69615794216433,13.303842057835668,10733,1547,8953,10500,85.26666666666667,14.733333333333333,1.6764948500754606,-9.7024294717036
ALABAMA,AL,CHILTON,01021,19310,3073,16085,19158,83.95970351811253,16.040296481887463,18369,2911,15081,17992,83.82058692752334,16.179413072476656,0.16596947801079676,-0.8598370655722332
ALABAMA,AL,CHOCTAW,01023,7464,3127,4296,7423,57.87417486191567,42.12582513808433,7292,3109,4106,7215,56.90921690921691,43.09078309078309,1.6956092617441687,-2.239360446677885
ALABAMA,AL,CLARKE,01025,13135,5755,7324,13079,55.998164997323954,44.001835002676046,13031,5749,7140,12889,55.39607417177438,44.60392582822562,1.0868835644969765,-1.3498606106294053
ALABAMA,AL,CLAY,01027,6930,1267,5601,6868,81.55212580081538,18.447874199184625,6624,1237,5245,6482,80.91638383215057,19.083616167849428,0.7856776817703137,-3.3313495884278566
ALABAMA,AL,CLEBURNE,01029,7227,675,6484,7159,90.57130884201705,9.428691157982959,6593,684,5764,6448,89.39205955334988,10.607940446650124,1.319187962062096,-11.116665808955972
ALABAMA,AL,COFFEE,01031,22275,5076,16899,21975,76.90102389078498,23.098976109215016,20767,4221,15875,20096,78.99582006369427,21.004179936305732,-2.6517810324903968,9.973234752614314
ALABAMA,AL,COLBERT,01033,27886,8343,19203,27546,69.71248094097146,30.287519059028533,24915,7312,16746,24058,69.60678360628481,30.39321639371519,0.15184918654553847,-0.34776620321274043
ALABAMA,AL,CONECUH,01035,6441,2966,3442,6408,53.714107365792756,46.285892634207244,6585,3080,3420,6500,52.61538461538461,47.38461538461539,2.088215753699685,-2.31873307716004
ALABAMA,AL,COOSA,01037,5479,1796,3631,5427,66.90620969227935,33.09379030772065,5252,1782,3381,5163,65.48518303312028,34.51481696687972,2.1699972319545235,-4.117149630324501
ALABAMA,AL,COVINGTON,01039,17430,2721,14586,17307,84.2780377881782,15.721962211821806,15940,2387,13267,15654,84.75150121374729,15.248498786252714,-0.5586490136322175,3.104983855826804
ALABAMA,AL,CRENSHAW,01041,6617,1700,4864,6564,74.1011578305911,25.898842169408898,6267,1664,4513,6177,73.06135664562085,26.93864335437915,1.4231889917042606,-3.8598869708901695
ALABAMA,AL,CULLMAN,01043,41851,4478,36880,41358,89.17259055080032,10.82740944919967,37873,3798,32989,36787,89.67570065512274,10.324299344877266,-0.5610328111706586,4.8730677745414175
ALABAMA,AL,DALE,01045,19738,5170,14303,19473,73.45041852821856,26.54958147178144,18749,4413,13808,18221,75.78069260743099,24.219307392569014,-3.0750234644647767,9.621555403881633
ALABAMA,AL,DALLAS,01047,17864,12230,5524,17754,31.114115128985016,68.88588487101498,18792,12836,5789,18625,31.081879194630872,68.91812080536913,0.10371295169215866,-0.04677425033857707
ALABAMA,AL,DEKALB,01049,29356,4281,24767,29048,85.26232442853208,14.737675571467916,25826,3622,21405,25027,85.52763015942782,14.472369840572181,-0.31019885667495917,1.8331878871141738
ALABAMA,AL,ELMORE,01051,41030,10367,30164,40531,74.42204732180306,25.577952678196937,37260,8443,27634,36077,76.59727804418327,23.402721955816727,-2.839827703962894,9.294776592598698
ALABAMA,AL,ESCAMBIA,01053,15910,4918,10869,15787,68.847786153164,31.152213846836005,14845,4605,9935,14540,68.32874828060523,31.671251719394775,0.7596185875193173,-1.638829677959719
ALABAMA,AL,ETOWAH,01055,47728,11567,35528,47095,75.4390062639346,24.5609937360654,44164,10442,32353,42795,75.5999532655684,24.40004673443159,-0.2128929909102295,0.6596175957593209
ALABAMA,AL,FAYETTE,01057,8766,1395,7300,8695,83.95629672225417,16.04370327774583,8249,1362,6712,8074,83.13103789943027,16.86896210056973,0.9927204611859475,-4.892173080381901
ALABAMA,AL,FRANKLIN,01059,12578,2086,10376,12462,83.26111378590916,16.738886214090837,12040,2197,9466,11663,81.1626511189231,18.83734888107691,2.585502861299238,-11.139904453827299
ALABAMA,AL,GENEVA,01061,12545,1595,10848,12443,87.18154785823354,12.818452141766455,11758,1525,9994,11519,86.76100355933674,13.238996440663252,0.48471580738365105,-3.1765572321260316
ALABAMA,AL,GREENE,01063,4775,3884,875,4759,18.386215591510823,81.61378440848918,4880,4013,838,4851,17.27478870336013,82.72521129663987,6.433808871621727,-1.3435165298826268
ALABAMA,AL,HALE,01065,7900,4663,3192,7855,40.63653723742839,59.36346276257161,8040,4775,3173,7948,39.92199295420232,60.07800704579768,1.7898512332432448,-1.1893608299645808
ALABAMA,AL,HENRY,01067,9298,2606,6607,9213,71.71388255725606,28.286117442743947,8072,2292,5632,7924,71.07521453811206,28.924785461887936,0.8985805013666637,-2.208030272119099
ALABAMA,AL,HOUSTON,01069,46173,12917,32618,45535,71.63280992643021,28.36719007356978,42639,10664,30728,41392,74.23656745264786,25.763432547352146,-3.5073786619760794,10.106407682408136
ALABAMA,AL,JACKSON,01071,23636,3717,19670,23387,84.10655492367555,15.893445076324454,20984,3673,16672,20345,81.9464241828459,18.05357581715409,2.636028066349505,-11.96511296547208
ALABAMA,AL,JEFFERSON,01073,325848,181688,138843,320531,43.31655908476871,56.68344091523129,304191,156873,134768,291641,46.210237929509226,53.789762070490774,-6.261986465325364,5.379608931804514
ALABAMA,AL,LAMAR,01075,7193,978,6174,7152,86.3255033557047,13.674496644295303,6966,1036,5823,6859,84.89575739903776,15.10424260096224,1.6841194430325501,-9.465856676427142
ALABAMA,AL,LAUDERDALE,01077,44339,11915,31721,43636,72.69456412136768,27.305435878632323,39525,9952,27899,37851,73.7074317719479,26.292568228052097,-1.374173032800885,3.8522963667717125
ALABAMA,AL,LAWRENCE,01079,16031,3562,12322,15884,77.5749181566356,22.425081843364392,14829,3627,10833,14460,74.91701244813278,25.08298755186722,3.5477999210699496,-10.596447903212269
ALABAMA,AL,LEE,01081,71449,27860,42221,70081,60.246001055921006,39.753998944078994,59191,21230,34617,55847,61.98542446326571,38.01457553673429,-2.806181327959656,4.575674942533192
ALABAMA,AL,LIMESTONE,01083,49235,13672,34640,48312,71.70061268421924,28.29938731578076,40294,9468,29067,38535,75.43012845465161,24.569871545348384,-4.944331723728334,15.17922372344862
ALABAMA,AL,LOWNDES,01085,6835,4972,1836,6808,26.968272620446534,73.03172737955347,6684,4883,1751,6634,26.39433222791679,73.60566777208321,2.1744834746101116,-0.7797502691055169
ALABAMA,AL,MACON,01087,8723,7108,1541,8649,17.817088680772343,82.18291131922766,9140,7566,1431,8997,15.905301767255752,84.09469823274425,12.019809127120041,-2.2733738912118384
ALABAMA,AL,MADISON,01089,194767,87286,102780,190066,54.07595256384624,45.92404743615376,163389,62822,89520,152342,58.76252116947395,41.23747883052605,-7.9754382765698795,11.36482815762847
ALABAMA,AL,MARENGO,01091,10900,5488,5343,10831,49.33062505770474,50.66937494229526,10994,5615,5233,10848,48.23930678466077,51.76069321533923,2.262300903111214,-2.10839191914175
ALABAMA,AL,MARION,01093,13807,1463,12205,13668,89.2961662276851,10.703833772314896,12984,1432,11274,12706,88.7297339839446,11.270266016055407,0.6383792876500705,-5.025899503468533
ALABAMA,AL,MARSHALL,01095,39655,5943,33191,39134,84.81371697245362,15.186283027546379,35316,4917,29233,34150,85.601756954612,14.398243045387995,-0.9205885605551467,5.473167661319667
ALABAMA,AL,MOBILE,01097,183164,79474,101243,180717,56.022953014934956,43.977046985065044,172737,72186,95116,167302,56.852876833510656,43.147123166489344,-1.459774535255387,1.9234742844228991
ALABAMA,AL,MONROE,01099,10668,4455,6147,10602,57.97962648556876,42.02037351443124,10271,4332,5795,10127,57.22326454033771,42.77673545966229,1.3217734977316375,-1.768161915825217
ALABAMA,AL,MONTGOMERY,01101,99139,64529,33311,97840,34.04640228945217,65.95359771054784,95878,58916,34003,92919,36.59423799222979,63.40576200777021,-6.962395837614155,4.018303103849452
ALABAMA,AL,MORGAN,01103,53722,13234,39664,52898,74.98204090891905,25.017959091080947,50644,11254,37486,48740,76.91013541239228,23.089864587607714,-2.5069446219731506,8.350393291210722
ALABAMA,AL,PERRY,01105,5230,3860,1339,5199,25.75495287555299,74.24504712444701,5278,3824,1407,5231,26.89734276428981,73.10265723571018,-4.247222109440152,1.5627200596188162
ALABAMA,AL,PICKENS,01107,9668,4022,5594,9616,58.173876871880196,41.826123128119804,9542,3972,5456,9428,57.87017394993636,42.12982605006364,0.5248004303677556,-0.7208739043520929
ALABAMA,AL,PIKE,01109,13841,5636,8042,13678,58.795145489106595,41.204854510893405,13168,5056,7693,12749,60.34198760687113,39.65801239312887,-2.563459009408564,3.900452958738132
ALABAMA,AL,RANDOLPH,01111,10837,2203,8559,10762,79.52982716967107,20.470172830328934,10187,2291,7705,9996,77.08083233293317,22.919167667066827,3.177177467622583,-10.685356782205135
ALABAMA,AL,RUSSELL,01113,21329,11228,9864,21092,46.76654655793666,53.23345344206334,19256,9579,9210,18789,49.01804247165895,50.98195752834105,-4.5931983412517035,4.416260227886859
ALABAMA,AL,SHELBY,01117,114950,33268,79700,112968,70.55095248211883,29.44904751788117,101254,22977,73020,95997,76.0648770274071,23.935122972592893,-7.2489758227066385,23.036959332116403
ALABAMA,AL,ST. CLAIR,01115,44441,7744,36166,43910,82.36392621270781,17.63607378729219,38400,5589,31651,37240,84.99194414607949,15.008055853920515,-3.092078854973346,17.510715304841874
ALABAMA,AL,SUMTER,01119,6291,4648,1598,6246,25.584373999359592,74.41562600064042,6411,4746,1581,6327,24.988146040777618,75.01185395922238,2.386043196678145,-0.7948449839755733
ALABAMA,AL,TALLADEGA,01121,35663,13138,22235,35373,62.85867752240409,37.14132247759591,33407,12121,20614,32735,62.97235374980907,37.02764625019093,-0.18051767265460095,0.3070036551523714
ALABAMA,AL,TALLAPOOSA,01123,20991,5859,14963,20822,71.8614926520027,28.13850734799731,19486,5519,13594,19113,71.12436561502642,28.87563438497358,1.0363917211804852,-2.5527648229257904
ALABAMA,AL,TUSCALOOSA,01125,90172,37765,51117,88882,57.511082108863434,42.488917891136566,82700,31762,47723,79485,60.04025916839655,39.95974083160345,-4.212468591182239,6.3293129707509
ALABAMA,AL,WALKER,01127,31170,4834,26002,30836,84.32351796601375,15.67648203398625,29472,4497,24266,28763,84.3653304592706,15.634669540729409,-0.049561227377670214,0.2674344548691421
ALABAMA,AL,WASHINGTON,01129,8876,2258,6564,8822,74.40489684878712,25.59510315121288,8533,2374,6042,8416,71.79182509505704,28.208174904942965,3.639790115755104,-9.263526486685937
ALABAMA,AL,WILCOX,01131,5903,4048,1833,5881,31.168168678796125,68.83183132120388,6118,4339,1737,6076,28.58788676761027,71.41211323238973,9.025787502800942,-3.6132272164934864
ALABAMA,AL,WINSTON,01133,11284,974,10195,11169,91.27943414808846,8.720565851911541,10313,872,9228,10100,91.36633663366337,8.633663366336634,-0.09511433726773211,1.0065540187001787
ALASKA,AK,DISTRICT 1,02001,7314,3477,3511,6988,50.24327418431597,49.75672581568403,6638,2573,3180,5753,55.27550843038415,44.72449156961585,-9.103913087305104,11.251629855277967
ALASKA,AK,DISTRICT 10,02010,11205,2727,8081,10808,74.76868985936343,25.231310140636566,9040,1808,6255,8063,77.5765843978668,22.4234156021332,-3.6195129758517353,12.522153575195038
ALASKA,AK,DISTRICT 11,02011,10628,3130,7096,10226,69.39174652845688,30.608253471543126,9689,2142,6444,8586,75.05241090146751,24.947589098532493,-7.542281860128696,22.690226100219093
ALASKA,AK,DISTRICT 12,02012,11238,2957,7893,10850,72.74654377880184,27.253456221198157,9543,1928,6629,8557,77.4687390440575,22.531260955942503,-6.095613951545142,20.958415396676667
ALASKA,AK,DISTRICT 13,02013,7713,2666,4652,7318,63.569281224378244,36.430718775621756,6533,1684,4028,5712,70.51820728291317,29.481792717086833,-9.854087797008804,23.57022900614696
ALASKA,AK,DISTRICT 14,02014,11443,4261,6714,10975,61.1753986332574,38.8246013667426,10420,3043,5978,9021,66.26759782729188,33.73240217270813,-7.684297244795091,15.09586885618961
ALASKA,AK,DISTRICT 15,02015,5559,2622,2671,5293,50.46287549593803,49.53712450406197,4982,1828,2525,4353,58.005972892258214,41.994027107741786,-13.004001174725454,17.962310156554583
ALASKA,AK,DISTRICT 16,02016,8118,4274,3516,7790,45.13478818998716,54.86521181001284,7436,3294,3203,6497,49.29967677389564,50.70032322610436,-8.448105254340742,8.2147180114309
ALASKA,AK,DISTRICT 17,02017,7239,4136,2810,6946,40.45493809386697,59.54506190613303,6788,3290,2618,5908,44.312796208530806,55.687203791469194,-8.705968579615709,6.927728188885696
ALASKA,AK,DISTRICT 18,02018,7720,4681,2760,7441,37.09178873807284,62.90821126192716,7402,3909,2684,6593,40.709843773699376,59.290156226300624,-8.88742058490527,6.102286224069009
ALASKA,AK,DISTRICT 19,02019,5301,3118,1975,5093,38.77871588454742,61.22128411545258,4792,2669,1636,4305,38.00232288037166,61.99767711962834,2.0430145983964865,-1.252293699129503
ALASKA,AK,DISTRICT 2,02002,6136,2104,3674,5778,63.58601592246452,36.41398407753548,5492,1585,3188,4773,66.79237376911796,33.20762623088204,-4.800484944189732,9.655486436641558
ALASKA,AK,DISTRICT 20,02020,7497,4881,2383,7264,32.805616740088105,67.19438325991189,7140,4151,2187,6338,34.5061533606816,65.49384663931839,-4.928212666356457,2.5964830405496464
ALASKA,AK,DISTRICT 21,02021,9429,5414,3690,9104,40.53163444639719,59.46836555360281,8647,4224,3479,7703,45.16422173179281,54.83577826820719,-10.257206053291878,8.448110762169136
ALASKA,AK,DISTRICT 22,02022,9520,4553,4684,9237,50.709104687669154,49.290895312330846,8372,3270,4203,7473,56.24247290244882,43.75752709755118,-9.838415576742431,12.645523140381787
ALASKA,AK,DISTRICT 23,02023,7739,3810,3655,7465,48.96182183523108,51.03817816476892,6924,2894,3246,6140,52.86644951140065,47.13355048859935,-7.385833004214781,8.28417896740885
ALASKA,AK,DISTRICT 24,02024,10428,4736,5378,10114,53.17381846944829,46.82618153055171,9080,3578,4709,8287,56.82394111258598,43.17605888741402,-6.42356473639456,8.454043136859134
ALASKA,AK,DISTRICT 25,02025,9325,4600,4407,9007,48.9286110802709,51.0713889197291,8127,3378,3816,7194,53.044203502919096,46.955796497080904,-7.758797664709416,8.7648229391744
ALASKA,AK,DISTRICT 26,02026,10111,4558,5243,9801,53.494541373329255,46.505458626670745,8905,3374,4548,7922,57.409745013885384,42.590254986114616,-6.819754450414617,9.192721766593248
ALASKA,AK,DISTRICT 27,02027,9506,4844,4324,9168,47.16404886561955,52.83595113438045,8783,3729,4085,7814,52.277962631174816,47.722037368825184,-9.782159648481969,10.716042414601468
ALASKA,AK,DISTRICT 28,02028,12749,6264,6162,12426,49.589570255915014,50.410429744084986,11427,4749,5423,10172,53.31301612268974,46.68698387731026,-6.984121585254011,7.975340357303118
ALASKA,AK,DISTRICT 29,02029,10747,2985,7464,10449,71.43267298306058,28.56732701693942,9394,2101,6347,8448,75.13020833333333,24.869791666666668,-4.921502857902027,14.867576696384678
ALASKA,AK,DISTRICT 3,02003,8385,1903,6076,7979,76.1498934703597,23.850106529640307,7613,1241,5403,6644,81.32149307645996,18.678506923540038,-6.3594498950453655,27.687435763843826
ALASKA,AK,DISTRICT 30,02030,10176,2638,7180,9818,73.1309839071094,26.869016092890607,8950,1816,6194,8010,77.32833957553059,22.67166042446941,-5.427965596392282,18.513666797386442
ALASKA,AK,DISTRICT 31,02031,12410,5037,6971,12008,58.05296469020653,41.94703530979347,10182,3466,5617,9083,61.84080149730266,38.15919850269734,-6.125141840636306,9.926405573818275
ALASKA,AK,DISTRICT 32,02032,8335,3506,4440,7946,55.87717090359929,44.12282909640071,7472,2701,3764,6465,58.22119102861562,41.77880897138438,-4.026060071262105,5.6105479852760265
ALASKA,AK,DISTRICT 33,02033,10955,7535,3059,10594,28.874834812157825,71.12516518784217,9934,5978,2732,8710,31.366245694603904,68.6337543053961,-7.942968076905322,3.6300081609410118
ALASKA,AK,DISTRICT 34,02034,10729,5763,4543,10306,44.08111779545896,55.91888220454104,9431,4220,3955,8175,48.379204892966364,51.620795107033636,-8.88416233176309,8.32627062135618
ALASKA,AK,DISTRICT 35,02035,10102,5011,4769,9780,48.76278118609407,51.23721881390593,9042,3749,4105,7854,52.2663610898905,47.7336389101095,-6.703317068067527,7.339855045189969
ALASKA,AK,DISTRICT 36,02036,9292,3796,5114,8910,57.39618406285073,42.60381593714927,8264,2693,4460,7153,62.35146092548581,37.64853907451419,-7.947330806822583,13.1619366499921
ALASKA,AK,DISTRICT 37,02037,5142,2560,2358,4918,47.946319642130945,52.053680357869055,5062,2421,1938,4359,44.45973847212664,55.54026152787336,7.842109040272849,-6.277574275113085
ALASKA,AK,DISTRICT 38,02038,5299,3202,1737,4939,35.169062563271915,64.83093743672808,5095,2758,1143,3901,29.300179441168932,70.69982055883106,20.030195152514207,-8.301128737970897
ALASKA,AK,DISTRICT 39,02039,5891,3580,1939,5519,35.13317630005436,64.86682369994564,5639,3142,1405,4547,30.899494171981527,69.10050582801847,13.701460951136779,-6.126846797055108
ALASKA,AK,DISTRICT 4,02004,10511,5345,4690,10035,46.73642252117588,53.26357747882412,9521,4162,4070,8232,49.44120505344995,50.55879494655005,-5.470705111960717,5.349776503046644
ALASKA,AK,DISTRICT 40,02040,4603,2318,1994,4312,46.2430426716141,53.7569573283859,4610,2338,1377,3715,37.065948855989234,62.934051144010766,24.758826089358287,-14.58208020746209
ALASKA,AK,DISTRICT 5,02005,8654,4204,4077,8281,49.23318439801956,50.76681560198044,7906,3187,3683,6870,53.6098981077147,46.3901018922853,-8.16400303709085,9.434585248072036
ALASKA,AK,DISTRICT 6,02006,9460,3272,5770,9042,63.813315638133155,36.186684361866845,8460,2536,4929,7465,66.02813127930341,33.971868720696584,-3.354351544194756,6.519557871189274
ALASKA,AK,DISTRICT 7,02007,9622,2215,7027,9242,76.03332611988748,23.96667388011253,8294,1510,5935,7445,79.71793149764943,20.282068502350572,-4.622053418270888,18.16681260757469
ALASKA,AK,DISTRICT 8,02008,9912,1953,7618,9571,79.594608713823,20.405391286176993,8073,1218,6126,7344,83.41503267973856,16.584967320261438,-4.580018544839016,23.035462730446497
ALASKA,AK,DISTRICT 9,02009,10993,2769,7787,10556,73.76847290640394,26.23152709359606,8954,1843,6100,7943,76.7971799068362,23.20282009316379,-3.9437737220382685,13.053184864044232
ALASKA,AK,DISTRICT 99,02099,433,373,59,432,13.657407407407407,86.3425925925926,NA,NA,NA,NA,NA,NA,NA,NA
ARIZONA,AZ,APACHE,04001,35172,23293,11442,34735,32.94083777170002,67.05916222829998,27661,17083,8240,25323,32.53958851636852,67.460411483631475,1.2331110306747162,-0.5947921847895166
ARIZONA,AZ,COCHISE,04003,60442,23732,35557,59289,59.97233888242339,40.02766111757661,50015,17450,28092,45542,61.68372052171622,38.31627947828378,-2.7744461987994518,4.46646089493834
ARIZONA,AZ,COCONINO,04005,73272,44698,27052,71750,37.70313588850174,62.29686411149826,59784,32404,21108,53512,39.44535805053072,60.55464194946928,-4.416798954637802,2.8771075279130587
ARIZONA,AZ,GILA,04007,27662,8943,18377,27320,67.26573938506588,32.734260614934115,36697,7003,14182,21185,66.94359216426717,33.05640783573283,0.48122189201951215,-0.9745378941340421
ARIZONA,AZ,GRAHAM,04009,14995,4034,10749,14783,72.71189880267875,27.288101197321247,20306,3301,8025,11326,70.85467066925658,29.145329330743422,2.6211795438179974,-6.3723010721416395
ARIZONA,AZ,GREENLEE,04011,3685,1182,2433,3615,67.30290456431536,32.697095435684645,5192,1092,1892,2984,63.40482573726541,36.59517426273459,6.147921363592501,-10.65189305853208
ARIZONA,AZ,LA PAZ,04012,7458,2236,5129,7365,69.64019008825527,30.359809911744737,5951,1575,4003,5578,71.76407314449624,28.235926855503763,-2.9595352704751776,7.521917262039457
ARIZONA,AZ,MARICOPA,04013,2068144,1040774,995665,2036439,48.892453935521765,51.107546064478235,1567834,702907,747361,1450268,51.532613282510546,48.467386717489454,-5.123278597409719,5.447290489124068
ARIZONA,AZ,MOHAVE,04015,104668,24831,78535,103366,75.97759417990441,24.02240582009558,79943,17455,58282,75737,76.95314047295246,23.046859527047545,-1.2677147248992715,4.232881672677125
ARIZONA,AZ,"NAVAJO",04017,51767,23383,27657,51040,54.18691222570533,45.81308777429467,40294,16459,20577,37036,55.559455664758616,44.440544335241384,-2.470404763025591,3.0884937607860596
ARIZONA,AZ,PIMA,04019,520397,304981,207758,512739,40.51925053487252,59.48074946512748,421640,224661,167428,392089,42.70152949967992,57.29847050032008,-5.1105405131302355,3.808616435573464
ARIZONA,AZ,PINAL,04021,184974,75106,107077,182183,58.77441912801963,41.22558087198037,129546,47892,72819,120711,60.32507393692373,39.67492606307627,-2.5704979831860153,3.9083999966095018
ARIZONA,AZ,SANTA CRUZ,04023,19556,13138,6194,19332,32.040140699358574,67.95985930064143,16433,11690,3897,15587,25.00160390068647,74.99839609931352,28.15234105232285,-9.384916431214885
ARIZONA,AZ,YAVAPAI,04025,143221,49602,91527,141129,64.85343196649873,35.14656803350127,114450,35590,71330,106920,66.71343060231949,33.28656939768051,-2.788042256301071,5.587835182409551
ARIZONA,AZ,YUMA,04027,69881,32210,36534,68744,53.14500174560689,46.85499825439311,53010,24605,25165,49770,50.56258790436006,49.43741209563994,5.1073608932586945,-5.223602392963011
ARKANSAS,AR,ARKANSAS,05001,6292,1818,4304,6122,70.30382228030055,29.696177719699445,6212,1939,3826,5765,66.36600173460538,33.633998265394624,5.93349070724849,-11.707857372837903
ARKANSAS,AR,ASHLEY,05003,7926,2125,5548,7673,72.3054867717972,27.69451322820279,8083,2408,5338,7746,68.9129873483088,31.087012651691197,4.9228738355828305,-10.912915504294517
ARKANSAS,AR,BAXTER,05005,21007,4635,15836,20471,77.35821405891261,22.64178594108739,19766,4169,14682,18851,77.88446236273937,22.115537637260623,-0.6756781620649965,2.3795410830986796
ARKANSAS,AR,BENTON,05007,119912,42249,73965,116214,63.64551603077082,36.35448396922918,96824,28005,60871,88876,68.48980602187318,31.51019397812683,-7.073008776744483,15.373723165478047
ARKANSAS,AR,BOONE,05009,17114,3064,13652,16716,81.67025604211534,18.329743957884663,16111,2926,12235,15161,80.7004814985819,19.299518501418113,1.2016961058038955,-5.024863928404189
ARKANSAS,AR,BRADLEY,05011,3654,1214,2335,3549,65.79318117779657,34.20681882220344,3653,1317,2164,3481,62.16604424016087,37.83395575983913,5.834595046169078,-9.586988367433435
ARKANSAS,AR,CALHOUN,05013,2182,479,1636,2115,77.35224586288416,22.64775413711584,2269,639,1556,2195,70.8883826879271,29.111617312072894,9.11836739654932,-22.20372405169129
ARKANSAS,AR,CARROLL,05015,11797,4023,7424,11447,64.85542063422731,35.14457936577269,10758,3342,6786,10128,67.00236966824644,32.997630331753555,-3.204288213460915,6.506373374190844
ARKANSAS,AR,CHICOT,05017,4103,2260,1752,4012,43.66899302093719,56.33100697906281,4176,2350,1716,4066,42.20363994097393,57.79636005902607,3.4721011789805356,-2.5353726055874937
ARKANSAS,AR,CLARK,05019,8395,3438,4616,8054,57.313136329774025,42.686863670225975,8526,3620,4404,8024,54.88534396809571,45.11465603190429,4.423389171232239,-5.381382848095795
ARKANSAS,AR,CLAY,05021,5183,962,4086,5048,80.94294770206022,19.057052297939777,5200,1199,3781,4980,75.92369477911646,24.076305220883533,6.610917629267377,-20.847272357180913
ARKANSAS,AR,CLEBURNE,05023,12680,1988,10328,12316,83.85839558298149,16.141604417018513,12085,2101,9458,11559,81.82368717017043,18.17631282982957,2.486698513817198,-11.194285837069495
ARKANSAS,AR,CLEVELAND,05025,3600,651,2867,3518,81.49516770892552,18.504832291074475,3354,723,2462,3185,77.29984301412873,22.70015698587127,5.4273392172736745,-18.481478773067483
ARKANSAS,AR,COLUMBIA,05027,8616,2814,5500,8314,66.15347606446957,33.84652393553043,8887,3140,5456,8596,63.47138203815728,36.52861796184272,4.225674532657719,-7.342445939547915
ARKANSAS,AR,CONWAY,05029,8685,2615,5694,8309,68.52810205800938,31.471897941990612,7927,2656,4849,7505,64.61025982678214,35.38974017321785,6.063808196609699,-11.070559467379681
ARKANSAS,AR,CRAIGHEAD,05031,38511,11921,25558,37479,68.19285466527923,31.807145334720776,35573,10538,22892,33430,68.4774154950643,31.522584504935686,-0.41555427833807057,0.9027204915273757
ARKANSAS,AR,CRAWFORD,05033,24091,4959,18607,23566,78.956971908682,21.043028091318,22450,4488,16686,21174,78.80419382261263,21.19580617738736,0.19387050188377497,-0.7207939381534412
ARKANSAS,AR,CRITTENDEN,05035,16367,8514,7333,15847,46.27374266422667,53.72625733577333,15952,8410,6964,15374,45.29725510602316,54.70274489397684,2.155732297504409,-1.7850796337480102
ARKANSAS,AR,CROSS,05037,6942,1772,4946,6718,73.62310211372433,26.376897886275678,6874,1999,4584,6583,69.63390551420325,30.36609448579675,5.72881352850072,-13.13700911187955
ARKANSAS,AR,DALLAS,05039,2649,963,1573,2536,62.026813880126184,37.973186119873816,2771,1165,1509,2674,56.43231114435303,43.56768885564697,9.913651633835263,-12.840944476787486
ARKANSAS,AR,DESHA,05041,4164,2016,1921,3937,48.79349758699517,51.20650241300483,4257,2228,1919,4147,46.27441523993248,53.72558476006752,5.443790772938506,-4.688794655865792
ARKANSAS,AR,DREW,05043,6908,2426,4349,6775,64.19188191881919,35.808118081180815,6595,2365,3968,6333,62.65592925943471,37.34407074056529,2.4514083144863807,-4.112975979654077
ARKANSAS,AR,FAULKNER,05045,54428,18347,34421,52768,65.23082171012734,34.76917828987265,47527,14629,29346,43975,66.73337123365549,33.26662876634451,-2.251571433829147,4.516687080261805
ARKANSAS,AR,FRANKLIN,05047,7129,1300,5677,6977,81.36734986383833,18.632650136161676,6770,1376,5039,6415,78.55027279812938,21.449727201870616,3.586336450986871,-13.133393442240449
ARKANSAS,AR,FULTON,05049,5119,1035,3961,4996,79.28342674139311,20.716573258606886,4772,1067,3471,4538,76.487439400617,23.512560599382986,3.655485610038034,-11.891462560864053
ARKANSAS,AR,GARLAND,05051,44199,14045,29069,43114,67.42357470891126,32.57642529108874,40805,12311,26087,38398,67.93843429345279,32.06156570654721,-0.757832572822692,1.6058466677951078
ARKANSAS,AR,GRANT,05053,8200,1268,6794,8062,84.27189283056313,15.728107169436864,7445,1373,5725,7098,80.65652296421527,19.343477035784726,4.4824271286178385,-18.690382601119538
ARKANSAS,AR,GREENE,05055,16100,3058,12670,15728,80.55696846388607,19.44303153611394,14600,3071,10720,13791,77.73185410775143,22.26814589224857,3.6344358288668666,-12.68679651105591
ARKANSAS,AR,HEMPSTEAD,05057,6848,2138,4470,6608,67.6452784503632,32.35472154963681,7049,2377,4401,6778,64.93065801121274,35.06934198878725,4.180799213033803,-7.740722480673834
ARKANSAS,AR,HOT SPRING,05059,12557,3082,9202,12284,74.91045262129599,25.089547378704005,11944,3149,8172,11321,72.18443600388659,27.81556399611342,3.7764603678037023,-9.800328398123836
ARKANSAS,AR,HOWARD,05061,4834,1340,3367,4707,71.53176120671341,28.468238793286595,4674,1351,3157,4508,70.03105590062111,29.96894409937888,2.142914006925589,-5.007534803748348
ARKANSAS,AR,INDEPENDENCE,05063,14512,2806,11250,14056,80.03699487763232,19.963005122367672,13614,2881,9936,12817,77.52204103924475,22.477958960755245,3.24417908077832,-11.188532921420869
ARKANSAS,AR,IZARD,05065,5810,1021,4631,5652,81.93559801840057,18.064401981599435,5448,1113,4042,5155,78.40931134820562,21.590688651794373,4.4972805009537264,-16.332441855215553
ARKANSAS,AR,JACKSON,05067,5091,1365,3593,4958,72.46873739411053,27.53126260588947,5156,1583,3267,4850,67.36082474226804,32.63917525773196,7.582912874636083,-15.649637625670287
ARKANSAS,AR,JEFFERSON,05069,25158,14981,9521,24502,38.858052403885395,61.141947596114605,25894,15772,9250,25022,36.96746862760771,63.03253137239229,5.114182405407597,-2.999377837307904
ARKANSAS,AR,JOHNSON,05071,9498,2283,6938,9221,75.24129703936666,24.758702960633336,9112,2427,6091,8518,71.50739610237144,28.492603897628552,5.22169892978579,-13.10480765608787
ARKANSAS,AR,LAFAYETTE,05073,2679,839,1757,2596,67.68104776579352,32.31895223420647,2860,1032,1758,2790,63.01075268817204,36.98924731182796,7.411901744348093,-12.626088436592974
ARKANSAS,AR,LAWRENCE,05075,5857,1080,4569,5649,80.88157195963888,19.118428040361128,5685,1263,4064,5327,76.29059508165948,23.709404918340528,6.017749465796318,-19.36352638875397
ARKANSAS,AR,LEE,05077,2848,1423,1286,2709,47.47139165743817,52.52860834256183,3026,1735,1229,2964,41.4642375168691,58.5357624831309,14.487554819077886,-10.26236592083385
ARKANSAS,AR,LINCOLN,05079,3875,1032,2729,3761,72.56048923158734,27.439510768412656,3826,1252,2455,3707,66.22605880766118,33.77394119233882,9.56486092932558,-18.75537825997946
ARKANSAS,AR,LITTLE RIVER,05081,5177,1226,3715,4941,75.18720906699049,24.812790933009513,5227,1397,3605,5002,72.07117153138745,27.928828468612554,4.323556103491377,-11.157064962839236
ARKANSAS,AR,LOGAN,05083,8225,1544,6441,7985,80.66374452097683,19.33625547902317,7921,1715,5746,7461,77.01380511995711,22.98619488004289,4.739331338497754,-15.878832577847312
ARKANSAS,AR,LONOKE,05085,30662,6686,22884,29570,77.38924585728779,22.61075414271221,27100,5664,19958,25622,77.89399734603076,22.106002653969245,-0.6479979278771641,2.2833232070219367
ARKANSAS,AR,MADISON,05087,7351,1563,5658,7221,78.35479850436228,21.645201495637725,6841,1588,4928,6516,75.6292203806016,24.370779619398405,3.603869126303705,-11.183795374322791
ARKANSAS,AR,MARION,05089,7503,1531,5783,7314,79.06754170084768,20.932458299152312,7107,1434,5336,6770,78.81831610044313,21.18168389955687,0.3162026451909439,-1.1766090060940426
ARKANSAS,AR,MILLER,05091,16529,4245,11920,16165,73.7395607794618,26.2604392205382,16091,4273,11294,15567,72.5509089741119,27.449091025888098,1.6383692804924577,-4.330386766646821
ARKANSAS,AR,MISSISSIPPI,05093,12342,4558,7296,11854,61.5488442719757,38.4511557280243,13204,5670,7061,12731,55.463042965988535,44.536957034011465,10.972714406815264,-13.664609599033973
ARKANSAS,AR,MONROE,05095,2816,1147,1545,2692,57.39227340267459,42.60772659732541,2884,1312,1489,2801,53.159585862192074,46.840414137807926,7.962228207448985,-9.036400762874642
ARKANSAS,AR,MONTGOMERY,05097,3873,731,3046,3777,80.64601535610272,19.353984643897274,3559,748,2643,3391,77.94161014450015,22.058389855499854,3.4697836067137056,-12.260211326930948
ARKANSAS,AR,NEVADA,05099,3358,1076,2133,3209,66.46930507946401,33.53069492053599,3246,1157,2000,3157,63.351282863477984,36.648717136522016,4.921798067933936,-8.50786182875357
ARKANSAS,AR,NEWTON,05101,3998,709,3192,3901,81.82517303255575,18.174826967444243,3753,699,2875,3574,80.44208170117516,19.557918298824845,1.7193629281232248,-7.071771700077645
ARKANSAS,AR,OUACHITA,05103,9629,3995,5294,9289,56.99214124232964,43.00785875767036,9935,4321,5351,9672,55.32464846980976,44.67535153019024,3.0140142208582077,-3.7324670436964302
ARKANSAS,AR,PERRY,05105,4627,1012,3479,4491,77.46604319750612,22.533956802493876,4306,1049,3008,4057,74.14345575548435,25.856544244515653,4.481295629083215,-12.850083176627603
ARKANSAS,AR,PHILLIPS,05107,6242,3623,2417,6040,40.01655629139073,59.98344370860927,6953,4310,2446,6756,36.2048549437537,63.7951450562463,10.528149756596793,-5.974908191330797
ARKANSAS,AR,PIKE,05109,4246,644,3519,4163,84.5303867403315,15.469613259668508,3981,685,3150,3835,82.13820078226858,17.86179921773142,2.9123914759273895,-13.392749122877767
ARKANSAS,AR,POINSETT,05111,7521,1424,5918,7342,80.60473985290112,19.395260147098885,7722,1880,5502,7382,74.53264697913845,25.467353020861555,8.146890147967301,-23.84265403942343
ARKANSAS,AR,POLK,05113,8490,1246,7035,8281,84.95350803043111,15.046491969568892,8231,1212,6618,7830,84.52107279693486,15.478927203065133,0.5116300813351016,-2.793702869864334
ARKANSAS,AR,POPE,05115,24432,5772,18081,23853,75.80178593887561,24.198214061124386,22569,5000,16256,21256,76.47722995859992,23.522770041400076,-0.8831962403580196,2.8714476166519898
ARKANSAS,AR,PRAIRIE,05117,3495,654,2786,3440,80.98837209302326,19.011627906976745,3444,814,2505,3319,75.4745405242543,24.525459475745706,7.305551687323031,-22.482072453002676
ARKANSAS,AR,PULASKI,05119,169956,101947,63687,165634,38.450438919545505,61.549561080454495,159776,89574,61257,150831,40.61300395807228,59.38699604192772,-5.32480936588523,3.641479082390342
ARKANSAS,AR,RANDOLPH,05121,6812,1215,5355,6570,81.5068493150685,18.493150684931507,6379,1425,4509,5934,75.98584428715874,24.014155712841255,7.26583362954456,-22.990627253064165
ARKANSAS,AR,SALINE,05125,56959,16060,39556,55616,71.12341772151899,28.876582278481013,52100,13256,35863,49119,73.01247989576335,26.98752010423665,-2.587314082388781,6.999761989793973
ARKANSAS,AR,SCOTT,05127,3551,483,2962,3445,85.97968069666183,14.020319303338171,3510,602,2731,3333,81.93819381938194,18.061806180618063,4.932360220422516,-22.3758733587606
ARKANSAS,AR,SEARCY,05129,4019,588,3365,3953,85.12522135087275,14.874778649127245,3728,601,2955,3556,83.09898762654669,16.90101237345332,2.438337436109461,-11.988830488691383
ARKANSAS,AR,SEBASTIAN,05131,47140,14487,31198,45685,68.28937287950093,31.71062712049907,44637,12300,29127,41427,70.30921862553407,29.690781374465928,-2.872803574721561,6.802939001700392
ARKANSAS,AR,SEVIER,05133,5202,1116,3884,5000,77.68,22.32,4562,1075,3282,4357,75.3270599036034,24.6729400963966,3.123631931748938,-9.53652093023255
ARKANSAS,AR,SHARP,05135,7566,1398,5938,7336,80.9432933478735,19.0567066521265,7249,1472,5407,6879,78.6015409216456,21.398459078354414,2.979270379142185,-10.943556345123518
ARKANSAS,AR,ST. FRANCIS,05123,7108,3604,3242,6846,47.35612036225533,52.64387963774467,7430,4031,3195,7226,44.2153335178522,55.7846664821478,7.103388337294847,-5.630197404529158
ARKANSAS,AR,STONE,05137,5938,1180,4616,5796,79.64113181504486,20.358868184955142,5618,1203,4113,5316,77.37020316027088,22.62979683972912,2.9351462992410537,-10.035126125335392
ARKANSAS,AR,UNION,05139,16607,5584,10478,16062,65.23471547752459,34.765284522475405,16894,5855,10456,16311,64.10397890993808,35.89602109006192,1.7639101141835756,-3.1500331603593
ARKANSAS,AR,VAN BUREN,05141,7807,1593,6034,7627,79.11367510161269,20.886324898387308,7339,1549,5382,6931,77.65113259269947,22.348867407300535,1.8834786564989825,-6.544145984039751
ARKANSAS,AR,WASHINGTON,05143,94266,43824,47504,91328,52.014716187806584,47.985283812193416,81861,33366,41476,74842,55.41808075679431,44.58191924320569,-6.141253039641703,7.633957054252205
ARKANSAS,AR,WHITE,05145,30885,5978,24182,30160,80.1790450928382,19.820954907161802,27219,5170,21077,26247,80.30251076313483,19.697489236865167,-0.1537506973609104,0.6268091776162166
ARKANSAS,AR,WOODRUFF,05147,2476,856,1543,2399,64.31846602751146,35.68153397248854,2571,1118,1347,2465,54.64503042596349,45.35496957403651,17.70231533616611,-21.32828153650783
ARKANSAS,AR,YELL,05149,6741,1284,5226,6510,80.27649769585254,19.723502304147466,6439,1480,4608,6088,75.68988173455979,24.31011826544021,6.059747823860739,-18.86710673807448
CALIFORNIA,CA,ALAMEDA,06001,770070,617659,136309,753968,18.078883984466184,81.92111601553381,654266,514842,95922,610764,15.705247853508066,84.29475214649193,15.11364960998003,-2.8158765172392797
CALIFORNIA,CA,ALPINE,06003,741,476,244,720,33.888888888888886,66.11111111111111,602,334,217,551,39.382940108892925,60.617059891107075,-13.95033282130058,9.063539587491686
CALIFORNIA,CA,AMADOR,06005,22304,8153,13585,21738,62.494249700984454,37.505750299015546,17734,6004,10485,16489,63.587846443083265,36.412153556916735,-1.7198203796344624,3.0033838575062033
CALIFORNIA,CA,BUTTE,06007,102066,50426,48730,99156,49.14478195974021,50.85521804025979,95564,41567,45144,86711,52.06259874756375,47.93740125243625,-5.604439382619331,6.086722916952558
CALIFORNIA,CA,CALAVERAS,06009,27164,10046,16518,26564,62.18190031621744,37.81809968378256,23136,7944,13511,21455,62.973665812164995,37.026334187835005,-1.2572961820409234,2.1383847829248293
CALIFORNIA,CA,COLUSA,06011,7961,3239,4559,7798,58.46370864324186,41.53629135675814,6632,2661,3551,6212,57.163554410817774,42.836445589182226,2.274446097386207,-3.0351589973011683
CALIFORNIA,CA,CONTRA COSTA,06013,581316,416386,152877,569263,26.855249682484196,73.1447503175158,466175,319287,115956,435243,26.641669136551307,73.3583308634487,0.8016785466337994,-0.2911469541618472
CALIFORNIA,CA,DEL NORTE,06015,11453,4677,6461,11138,58.008619141677144,41.991380858322856,9558,3485,5134,8619,59.566074950690336,40.433925049309664,-2.614669189303598,3.851854122778975
CALIFORNIA,CA,EL DORADO,06017,116159,51621,61838,113459,54.50250751372742,45.49749248627258,93591,36404,49247,85651,57.49728549579106,42.50271450420894,-5.208555423512751,7.046086390004747
CALIFORNIA,CA,FRESNO,06019,364917,193025,164464,357489,46.0053316325817,53.9946683674183,282319,141341,124049,265390,46.74215305776404,53.25784694223596,-1.57635319937397,1.3834983340229812
CALIFORNIA,CA,GLENN,06021,11297,3995,7063,11058,63.87230964007958,36.12769035992042,9470,3065,5788,8853,65.37896758161075,34.62103241838925,-2.3044994395949314,4.351857343026255
CALIFORNIA,CA,HUMBOLDT,06023,68843,44768,21770,66538,32.718146021822115,67.28185397817788,59246,33200,18373,51573,35.625230256141776,64.37476974385822,-8.160183705250523,4.515875157125526
CALIFORNIA,CA,IMPERIAL,06025,56743,34678,20847,55525,37.54524988743809,62.45475011256191,48091,32667,12704,45371,28.0002644861255,71.9997355138745,34.08891157453979,-13.256972866897886
CALIFORNIA,CA,INYO,06027,9484,4634,4620,9254,49.92435703479576,50.07564296520424,8086,3155,4248,7403,57.382142374712956,42.617857625287044,-12.996700770105218,17.499202811856417
CALIFORNIA,CA,KERN,06029,305292,133366,164484,297850,55.223770354205136,44.776229645794864,244163,98689,129584,228273,56.767116566567225,43.232883433432775,-2.7187327905800918,3.569843345606216
CALIFORNIA,CA,KINGS,06031,43861,18699,24072,42771,56.28112506137336,43.71887493862664,33915,13617,18093,31710,57.05771050141911,42.94228949858089,-1.3610525785580418,1.8084397667511798
CALIFORNIA,CA,LAKE,06033,28812,14941,13123,28064,46.76097491448119,53.23902508551881,24496,11496,10599,22095,47.970128988458924,52.029871011541076,-2.520639613599218,2.3239613138950954
CALIFORNIA,CA,LASSEN,06035,11987,2799,8970,11769,76.2171807290339,23.782819270966097,10524,2224,7574,9798,77.30149010002042,22.698509899979587,-1.4027017714451917,4.777006842142906
CALIFORNIA,CA,LOS ANGELES,06037,4264365,3028885,1145530,4174415,27.441689434327923,72.55831056567207,3434308,2464364,769743,3234107,23.800789522424584,76.19921047757542,15.29739132591783,-4.7781333810208215
CALIFORNIA,CA,MADERA,06039,53732,23168,29378,52546,55.90910820994938,44.09089179005062,43112,17029,23357,40386,57.83439805873322,42.16560194126678,-3.3289701516883263,4.566020073579424
CALIFORNIA,CA,MARIN,06041,155830,128288,24612,152900,16.096795291039896,83.9032047089601,139273,108707,21771,130478,16.685571513971706,83.31442848602829,-3.528654816760668,0.7066917863219224
CALIFORNIA,CA,MARIPOSA,06043,10280,4088,5950,10038,59.274755927475596,40.725244072524404,8877,3122,5185,8307,62.417238473576504,37.582761526423496,-5.034638864119623,8.36149984319674
CALIFORNIA,CA,MENDOCINO,06045,43340,28782,13267,42049,31.551285405122595,68.4487145948774,37477,22079,10888,32967,33.026966360299696,66.9730336397003,-4.468109299166379,2.203395717619605
CALIFORNIA,CA,MERCED,06047,90554,48991,39397,88388,44.57279268679006,55.42720731320994,70789,37317,28725,66042,43.495048605432906,56.504951394567094,2.4778546430283432,-1.9073444977085297
CALIFORNIA,CA,MODOC,06049,4343,1150,3109,4259,72.99835642169523,27.001643578304765,3788,877,2696,3573,75.45479988804925,24.54520011195074,-3.2555165078942516,10.007836380026136
CALIFORNIA,CA,MONO,06051,6738,4013,2513,6526,38.507508427827155,61.492491572172845,5276,2773,2111,4884,43.222768222768224,56.777231777231776,-10.909203618423579,8.30484271132066
CALIFORNIA,CA,MONTEREY,06053,163923,113953,46299,160252,28.891371090532413,71.10862890946758,133408,89088,34895,123983,28.144987619270385,71.85501238072962,2.6519232531159176,-1.0387354292102247
CALIFORNIA,CA,"NAPA",06055,72150,49817,20676,70493,29.330571829827075,70.66942817017292,61372,39199,17411,56610,30.756050167814873,69.24394983218512,-4.634790001349098,2.0586323302504983
CALIFORNIA,CA,NEVADA,06057,64750,36359,26779,63138,42.41344356805727,57.58655643194273,54935,26053,23365,49418,47.28034319478733,52.71965680521267,-10.293706216723564,9.231660298382005
CALIFORNIA,CA,ORANGE,06059,1522113,814009,676498,1490507,45.38710653489048,54.61289346510952,1197521,609961,507148,1117109,45.39825567603519,54.60174432396481,-0.024558523182638403,0.020419020093132012
CALIFORNIA,CA,PLACER,06061,235084,106869,122488,229357,53.4049538492394,46.5950461507606,182839,73509,95138,168647,56.412506596618975,43.587493403381025,-5.33135811334402,6.900036025348233
CALIFORNIA,CA,PLUMAS,06063,11260,4561,6445,11006,58.558967835725966,41.441032164274034,9676,3459,5420,8879,61.042910237639376,38.957089762360624,-4.069174277968479,6.376098463888158
CALIFORNIA,CA,RIVERSIDE,06065,997156,528340,449144,977484,45.94898740030527,54.05101259969473,751391,373695,333243,706938,47.138928732081176,52.861071267918824,-2.524328328586034,2.2510730547719238
CALIFORNIA,CA,SACRAMENTO,06067,718440,440808,259405,700213,37.04658439646222,62.95341560353778,559330,326023,189789,515812,36.794219599388924,63.205780400611076,0.6858816407061097,-0.3992748692821402
CALIFORNIA,CA,SAN BENITO,06069,28830,17628,10590,28218,37.52923665745269,62.47076334254731,21924,12521,7841,20362,38.50800510755329,61.49199489244671,-2.5417272262400648,1.5917005974721121
CALIFORNIA,CA,SAN BERNARDINO,06071,841130,455859,366257,822116,44.550525716565545,55.449474283434455,653983,340833,271240,612073,44.314975501288245,55.685024498711755,0.5315363770661552,-0.4230046002453469
CALIFORNIA,CA,SAN DIEGO,06073,1602143,964650,600094,1564744,38.35093791700112,61.64906208299888,1306400,735476,477766,1213242,39.379282946023956,60.620717053976044,-2.611385866097049,1.6963590650160176
CALIFORNIA,CA,SAN FRANCISCO,06075,443553,378156,56417,434573,12.982168703531972,87.01783129646803,405792,345084,37688,382772,9.8460702454725,90.1539297545275,31.85127040406337,-3.4786042789243687
CALIFORNIA,CA,SAN JOAQUIN,06077,NA,161137,121098,282235,42.90679752688362,57.09320247311638,224166,121124,88936,210060,42.338379510616015,57.661620489383985,1.342559688958045,-0.9857822437929209
CALIFORNIA,CA,SAN LUIS OBISPO,06079,159714,88310,67436,155746,43.29870430059199,56.70129569940801,135009,67107,56164,123271,45.561405358924645,54.438594641075355,-4.96626704226416,4.156428124662481
CALIFORNIA,CA,SAN MATEO,06081,374251,291496,75584,367080,20.590606952163018,79.40939304783699,314384,237882,57929,295811,19.583112189877998,80.416887810122,5.144712201596691,-1.2528397824395854
CALIFORNIA,CA,SANTA BARBARA,06083,200339,129963,65736,195699,33.59036070700412,66.40963929299588,176786,107142,56365,163507,34.47253022806363,65.52746977193637,-2.5590506853522044,1.3462590942849406
CALIFORNIA,CA,SANTA CLARA,06085,850741,617967,214612,832579,25.77677313504184,74.22322686495816,703709,511684,144826,656510,22.059983854015933,77.94001614598406,16.848558483188913,-4.768781769385622
CALIFORNIA,CA,SANTA CRUZ,06087,144837,114246,26937,141183,19.079492573468478,80.92050742653153,128821,95249,22438,117687,19.065827151682004,80.934172848318,0.07167494847066802,-0.016884612896561624
CALIFORNIA,CA,SHASTA,06089,92930,30000,60789,90789,66.9563493374748,33.043650662525195,80053,22301,51778,74079,69.89565193914605,30.104348060853955,-4.2052724599096925,9.763714516353694
CALIFORNIA,CA,SIERRA,06091,1931,730,1142,1872,61.004273504273506,38.995726495726494,1830,601,1048,1649,63.55366889023651,36.44633110976349,-4.011405526195599,6.994930102251229
CALIFORNIA,CA,SISKIYOU,06093,23472,9593,13290,22883,58.07804920683477,41.92195079316523,20492,7234,11341,18575,61.05518169582773,38.94481830417227,-4.876134025486656,7.644489353475836
CALIFORNIA,CA,SOLANO,06095,205877,131639,69306,200945,34.49003458657842,65.50996541342158,166113,102360,51920,154280,33.653098262898624,66.34690173710138,2.4869517722904133,-1.2614550216619613
CALIFORNIA,CA,SONOMA,06097,268317,199938,61825,261763,23.618693245416654,76.38130675458335,231253,160435,51408,211843,24.26702794050311,75.73297205949689,-2.6716691334267018,0.8560798255443203
CALIFORNIA,CA,STANISLAUS,06099,214954,105841,104145,209986,49.596163553760725,50.403836446239275,172146,81647,78494,160141,49.01555504211913,50.98444495788087,1.1845392980711411,-1.1387953955784846
CALIFORNIA,CA,SUTTER,06101,42644,17367,24375,41742,58.39442288342676,41.60557711657324,33523,13076,18176,31252,58.159477793421225,41.840522206578775,0.4039669868427076,-0.5615252334699505
CALIFORNIA,CA,TEHAMA,06103,28731,8911,19141,28052,68.2339940111222,31.766005988877797,23908,6809,15494,22303,69.4704748240147,30.52952517598529,-1.7798652104002444,4.050114784835013
CALIFORNIA,CA,TRINITY,06105,6259,2851,3188,6039,52.79019705249213,47.20980294750787,5686,2214,2812,5026,55.94906486271389,44.05093513728611,-5.645970702053537,7.170943818507025
CALIFORNIA,CA,TULARE,06107,146885,66105,77579,143684,53.99278973302525,46.00721026697475,112334,47585,58299,105884,55.05931018850818,44.94068981149182,-1.9370392615371546,2.373173308991383
CALIFORNIA,CA,TUOLUMNE,06109,30408,11978,17689,29667,59.62517275086797,40.37482724913203,25529,9123,14551,23674,61.46405339190673,38.53594660809327,-2.991798522160105,4.771857973906801
CALIFORNIA,CA,VENTURA,06111,422825,251388,162207,413595,39.21880100097922,60.78119899902078,351726,194402,132323,326725,40.49980870762874,59.50019129237126,-3.1629969314107442,2.152947207102107
CALIFORNIA,CA,YOLO,06113,97294,67598,27292,94890,28.761724101591316,71.23827589840869,82090,54752,20739,75491,27.47214899789379,72.52785100210622,4.694118045866724,-1.7780412433012538
CALIFORNIA,CA,YUBA,06115,29796,11230,17676,28906,61.149934269701795,38.850065730298205,22998,7910,13170,21080,62.47628083491461,37.52371916508539,-2.12296018182887,3.5346884443345328
COLORADO,CO,ADAMS,08001,236740,134202,95657,229859,41.61551211829861,58.38448788170139,193665,96558,80082,176640,45.33627717391305,54.66372282608695,-8.207037029841091,6.8066440835946596
COLORADO,CO,ALAMOSA,08003,7808,3759,3813,7572,50.35657686212361,49.64342313787639,6939,3189,3046,6235,48.8532477947073,51.1467522052927,3.077234647189986,-2.939246389257033
COLORADO,CO,ARAPAHOE,08005,350183,213607,127323,340930,37.345789458246564,62.654210541753436,303046,159885,117053,276938,42.266861174703365,57.733138825296635,-11.642860576081892,8.523824993039453
COLORADO,CO,ARCHULETA,08007,9144,3738,5189,8927,58.12703035734289,41.87296964265711,7339,2500,4264,6764,63.03962152572442,36.96037847427558,-7.792862725828487,13.29150666517307
COLORADO,CO,BACA,08009,2225,317,1867,2184,85.48534798534799,14.514652014652015,2153,283,1753,2036,86.10019646365423,13.899803536345775,-0.7141081014440998,4.423432868662558
COLORADO,CO,BENT,08011,2274,732,1503,2235,67.24832214765101,32.75167785234899,1927,590,1188,1778,66.81664791901012,33.18335208098988,0.6460578943800588,-1.3008758958025335
COLORADO,CO,BOULDER,08013,206111,159089,42501,201590,21.082891016419467,78.91710898358053,188142,132334,41396,173730,23.82777873712082,76.17222126287918,-11.519696195706008,3.603528524169497
COLORADO,CO,BROOMFIELD,08014,46632,29077,16295,45372,35.91422022392665,64.08577977607335,37689,19731,14367,34098,42.13443603730424,57.86556396269576,-14.762784074932078,10.74942571610913
COLORADO,CO,CHAFFEE,08015,13718,7160,6222,13382,46.49529218353012,53.50470781646988,11250,4888,5391,10279,52.446736063819436,47.553263936180564,-11.34759629855201,12.51532153140218
COLORADO,CO,CHEYENNE,08017,1136,131,993,1124,88.34519572953737,11.654804270462634,1102,132,925,1057,87.51182592242195,12.488174077578051,0.9522939309416278,-6.673271864552999
COLORADO,CO,CLEAR CREEK,08019,6548,3604,2754,6358,43.31550802139037,56.68449197860963,5866,2729,2575,5304,48.548265460030166,51.451734539969834,-10.77846425419241,10.170225523834908
COLORADO,CO,CONEJOS,08021,4333,1959,2286,4245,53.851590106007066,46.148409893992934,4022,1771,1914,3685,51.940298507462686,48.059701492537314,3.6797855489216547,-3.9769110901389237
COLORADO,CO,COSTILLA,08023,2094,1311,741,2052,36.111111111111114,63.888888888888886,1848,1125,588,1713,34.32574430823117,65.67425569176882,5.201247165532896,-2.718518518518509
COLORADO,CO,CROWLEY,08025,1750,437,1271,1708,74.41451990632318,25.585480093676814,1527,339,1079,1418,76.09308885754584,23.90691114245416,-2.2059414020701884,7.02127071632368
COLORADO,CO,CUSTER,08027,3635,1112,2474,3586,68.99051868377022,31.00948131622978,3066,797,2061,2858,72.11336599020294,27.88663400979706,-4.330469481700494,11.198365874259375
COLORADO,CO,DELTA,08029,19370,5887,13081,18968,68.96351750316322,31.03648249683678,16790,4087,11655,15742,74.03760640325244,25.962393596747553,-6.853394033908589,19.543994975582237
COLORADO,CO,DENVER,08031,393829,313293,71618,384911,18.606379136995304,81.3936208630047,331852,244551,62690,307241,20.404177827828967,79.59582217217103,-8.810934241034063,2.2586596152558203
COLORADO,CO,DOLORES,08033,1449,341,1089,1430,76.15384615384616,23.846153846153847,1255,242,944,1186,79.59527824620574,20.404721753794266,-4.3236636245110756,16.86586141131596
COLORADO,CO,DOUGLAS,08035,231605,104653,121270,225923,53.67758041456602,46.32241958543398,187499,68657,102573,171230,59.9036383811248,40.0963616188752,-10.393455447475064,15.527737967197218
COLORADO,CO,EAGLE,08037,29140,18588,9892,28480,34.73314606741573,65.26685393258427,25223,14099,8990,23089,38.93629000822903,61.06370999177097,-10.794926635087677,6.883210897896186
COLORADO,CO,EL PASO,08041,378851,161941,202828,364769,55.60450586535588,44.39549413464412,318967,108010,179228,287238,62.397036603791975,37.602963396208025,-10.885982905834501,18.06381764880016
COLORADO,CO,ELBERT,08039,18983,4490,14027,18517,75.75201166495653,24.247988335043473,15978,3134,11705,14839,78.879978435204535,21.120021564795472,-3.965476198522866,14.810433600418026
COLORADO,CO,FREMONT,08043,25557,7369,17517,24886,70.38897372016395,29.611026279836054,21973,5297,15122,20419,74.05847494980165,25.941525050198344,-4.95487009707527,14.14527951821265
COLORADO,CO,GARFIELD,08045,30904,15427,14717,30144,48.82231953290871,51.17768046709129,26470,11271,13132,24403,53.81305577183133,46.18694422816867,-9.274210816206885,10.805512948134922
COLORADO,CO,GILPIN,08047,4186,2223,1833,4056,45.19230769230769,54.80769230769231,3576,1634,1566,3200,48.9375,51.0625,-7.653011101286966,7.3345259391770945
COLORADO,CO,GRAND,08049,9870,4710,4883,9593,50.90169915563432,49.09830084436568,8588,3358,4494,7852,57.23382577687214,42.76617422312786,-11.063608862919306,14.806390181643646
COLORADO,CO,GUNNISON,08051,11190,7132,3735,10867,34.370111346277724,65.62988865372228,9412,5128,3289,8417,39.07568017108233,60.92431982891767,-12.042193006500579,7.723629640869811
COLORADO,CO,HINSDALE,08053,632,255,353,608,58.05921052631579,41.94078947368421,589,197,339,536,63.24626865671642,36.75373134328358,-8.201366247477104,14.113010953780392
COLORADO,CO,HUERFANO,08055,4406,2076,2203,4279,51.48399158681935,48.51600841318065,3783,1633,1883,3516,53.5551763367463,46.4448236632537,-3.867384801244378,4.4594522845947004
COLORADO,CO,JACKSON,08057,876,175,681,856,79.55607476635514,20.44392523364486,861,171,629,800,78.625,21.375,1.1841968411512083,-4.355905339673183
COLORADO,CO,JEFFERSON,08059,377358,218396,148417,366813,40.461215932914044,59.538784067085956,328882,160776,138177,298953,46.220308877984166,53.779691122015834,-12.460091861941914,10.7086761283248
COLORADO,CO,KIOWA,08061,903,98,795,893,89.02575587905935,10.97424412094065,855,91,728,819,88.88888888888889,11.11111111111111,0.1539753639417718,-1.2318029115341411
COLORADO,CO,KIT CARSON,08063,3871,662,3144,3806,82.60641093011036,17.393589069889646,3702,536,2967,3503,84.6988295746503,15.3011704253497,-2.470422147564355,13.67489274593925
COLORADO,CO,LA PLATA,08067,35667,20548,14233,34781,40.92176763175297,59.07823236824703,31150,15525,12587,28112,44.774473534433696,55.225526465566304,-8.604692804970249,6.976313580429028
COLORADO,CO,LAKE,08065,3961,2303,1497,3800,39.39473684210526,60.60526315789474,3199,1616,1270,2886,44.005544005544,55.994455994456,-10.477786987152927,8.234399426784789
COLORADO,CO,LARIMER,08069,224338,126120,91489,217609,42.04283830172465,57.95716169827535,195980,93113,83430,176543,47.25760862792634,52.74239137207366,-11.034774034503469,9.887246654050719
COLORADO,CO,LAS ANIMAS,08071,7961,3497,4284,7781,55.057190592468835,44.942809407531165,6793,2650,3710,6360,58.333333333333336,41.666666666666664,-5.616244698624861,7.8627425780747995
COLORADO,CO,LINCOLN,08073,2651,470,2135,2605,81.95777351247601,18.042226487523994,2436,409,1892,2301,82.22511951325511,17.774880486744895,-0.3251390844570379,1.5040663760212958
COLORADO,CO,LOGAN,08075,10532,2218,8087,10305,78.47646773410966,21.523532265890346,9722,1851,7282,9133,79.73283696485274,20.267163035147266,-1.5757237275990765,6.199038457253669
COLORADO,CO,MESA,08077,90623,31536,56894,88430,64.33789437973539,35.66210562026462,77653,21729,49779,71508,69.61319013257258,30.38680986742742,-7.578011785971639,17.36047902314337
COLORADO,CO,MINERAL,08079,756,317,427,744,57.39247311827957,42.60752688172043,652,237,344,581,59.20826161790017,40.79173838209983,-3.0667823205801414,4.451363368268235
COLORADO,CO,MOFFAT,08081,7026,1203,5670,6873,82.49672632038411,17.503273679615887,6525,874,5305,6179,85.85531639423856,14.14468360576145,-3.91191857989569,23.744540121677993
COLORADO,CO,MONTEZUMA,08083,15500,5836,9306,15142,61.45819574692907,38.54180425307093,12858,3973,7853,11826,66.40453238626755,33.59546761373245,-7.448793721739055,14.723226050041994
COLORADO,CO,MONTROSE,08085,24922,7687,16770,24457,68.56932575540745,31.43067424459255,21186,5466,14382,19848,72.46070133010883,27.539298669891174,-5.3703255740977,14.130263887060535
COLORADO,CO,MORGAN,08087,13744,3876,9593,13469,71.22280792931917,28.777192070680822,11960,3151,8145,11296,72.10516997167139,27.894830028328613,-1.2237153628496755,3.1631741131102897
COLORADO,CO,OTERO,08089,9576,3605,5756,9361,61.489157141331056,38.510842858668944,8452,2943,4928,7871,62.6095794689366,37.3904205310634,-1.7895381778780917,2.9965491473269656
COLORADO,CO,OURAY,08091,4020,2365,1577,3942,40.0050735667174,59.9949264332826,3310,1697,1351,3048,44.324146981627294,55.675853018372706,-9.744289984193454,7.757534336267158
COLORADO,CO,PARK,08093,12291,4903,6991,11894,58.777534891541954,41.222465108458046,10417,3421,6135,9556,64.2005023022185,35.7994976977815,-8.446923647339045,15.148166201819668
COLORADO,CO,PHILLIPS,08095,2485,486,1958,2444,80.11456628477904,19.885433715220948,2332,436,1791,2227,80.42209250112259,19.577907498877412,-0.382390219875528,1.5707818435712229
COLORADO,CO,PITKIN,08097,11957,8989,2780,11769,23.621378196958112,76.3786218030419,10523,7333,2550,9883,25.801882019629666,74.19811798037033,-8.450948737044307,2.9387589362420696
COLORADO,CO,PROWERS,08099,5561,1458,4008,5466,73.32601536772778,26.67398463227223,5016,1186,3531,4717,74.8569005723977,25.14309942760229,-2.0450822742645314,6.088689300529593
COLORADO,CO,PUEBLO,08101,88301,43772,42252,86024,49.116525620756995,50.883474379243005,78646,35875,36265,72140,50.2703077349598,49.7296922650402,-2.2951562586127183,2.3201070862324924
COLORADO,CO,RIO BLANCO,08103,3691,561,3061,3622,84.51131971286581,15.48868028713418,3450,436,2791,3227,86.48899907034398,13.511000929656028,-2.286625326614844,14.637548822435775
COLORADO,CO,RIO GRANDE,08105,6305,2495,3660,6155,59.46385052802599,40.53614947197401,5534,2001,3085,5086,60.65670467951239,39.34329532048761,-1.9665660338605506,3.0319121511543257
COLORADO,CO,ROUTT,08107,16876,10582,5925,16507,35.89386320954746,64.10613679045254,13986,7600,5230,12830,40.76383476227591,59.23616523772409,-11.946794459178978,8.221280923882368
COLORADO,CO,SAGUACHE,08109,3389,1884,1413,3297,42.857142857142854,57.142857142857146,2835,1417,1147,2564,44.73478939157566,55.26521060842434,-4.197284842446136,3.397519911281388
COLORADO,CO,SAN JUAN,08111,562,342,202,544,37.13235294117647,62.86764705882353,506,265,215,480,44.791666666666664,55.208333333333336,-17.09986320109439,13.873473917869038
COLORADO,CO,SAN MIGUEL,08113,5147,3924,1136,5060,22.450592885375492,77.5494071146245,4329,2975,1033,4008,25.773453093812375,74.22654690618762,-12.892568940382409,4.476646627030245
COLORADO,CO,SEDGWICK,08115,1446,301,1121,1422,78.83263009845288,21.167369901547115,1364,267,1015,1282,79.17316692667707,20.826833073322934,-0.4301164667816826,1.6350869430089787
COLORADO,CO,SUMMIT,08117,18479,12631,5322,17953,29.644070628864256,70.35592937113574,16174,9557,5100,14657,34.795660776420824,65.20433922357918,-14.805266037791498,7.9006860722754535
COLORADO,CO,TELLER,08119,16939,5278,11241,16519,68.04891337248017,31.951086627519825,14444,3603,9745,13348,73.00719208870242,26.99280791129757,-6.791493515047165,18.368888233176417
COLORADO,CO,WASHINGTON,08121,3008,369,2595,2964,87.5506072874494,12.449392712550607,2733,296,2299,2595,88.59344894026975,11.406551059730251,-1.1771092166458552,9.142480030637913
COLORADO,CO,WELD,08123,166974,66060,96145,162205,59.27375851545883,40.72624148454117,135428,46519,76651,123170,62.23187464479987,37.76812535520013,-4.753377824828586,7.832308597582416
COLORADO,CO,YUMA,08125,4981,785,4107,4892,83.9533932951758,16.046606704824203,4791,726,3850,4576,84.13461538461539,15.865384615384615,-0.21539539773390848,1.1422483213161971
CONNECTICUT,CT,FAIRFIELD,09001,472396,297505,168445,465950,36.15087455735594,63.84912544264406,421209,243852,160077,403929,39.62998447747005,60.37001552252995,-8.77898380730382,5.762976686358012
CONNECTICUT,CT,HARTFORD,09003,449336,283368,159024,442392,35.94640047740465,64.05359952259535,406864,240403,148173,388576,38.132308737544264,61.867691262455736,-5.732430929332677,3.533198371451318
CONNECTICUT,CT,LITCHFIELD,09005,107544,50164,55601,105765,52.57032099465797,47.42967900534203,97442,39775,53051,92826,57.15101372460302,42.84898627539698,-8.01506820512109,10.690317620361522
CONNECTICUT,CT,MIDDLESEX,09007,99198,56848,40665,97513,41.70213202342252,58.29786797657748,88624,45357,38867,84224,46.14717895136778,53.85282104863222,-9.632326458416173,8.254065137889665
CONNECTICUT,CT,NEW HAVEN,09009,417983,242630,169893,412523,41.18388550456581,58.81611449543419,379006,205609,159048,364657,43.61578140554,56.38421859446,-5.575724709279872,4.313079016782062
CONNECTICUT,CT,NEW LONDON,09011,139604,79459,57110,136569,41.81768922669127,58.18231077330873,123528,62278,54058,116336,46.46712969330216,53.53287030669784,-10.005869734796779,8.685206752362706
CONNECTICUT,CT,TOLLAND,09013,80714,44151,34838,78989,44.104875362392235,55.895124637607765,77424,38506,34194,72700,47.034387895460796,52.965612104539204,-6.228448299528699,5.530970787775535
CONNECTICUT,CT,WINDHAM,09015,57082,26706,29141,55847,52.18006338746934,47.81993661253066,50823,21792,25747,47539,54.1597425271882,45.8402574728118,-3.655259510742803,4.318647513908536
DELAWARE,DE,KENT,10001,87025,44552,41009,85561,47.92954734049392,52.07045265950608,74598,33351,36991,70342,52.587358903642205,47.412641096357795,-8.857283689950979,9.823986716289678
DELAWARE,DE,NEW CASTLE,10003,287633,195034,88364,283398,31.180177700618916,68.81982229938109,262391,162919,85525,248444,34.42425657290979,65.5757434270902,-9.423816794474526,4.947071436403583
DELAWARE,DE,SUSSEX,10005,129352,56682,71230,127912,55.6867221214585,44.3132778785415,106008,39333,62611,101944,61.41705249941144,38.58294750058856,-9.330194375589507,14.85197671293912
DISTRICT OF COLUMBIA,DC,DISTRICT OF COLUMBIA,NA,344356,317323,18586,335909,5.533046152380556,94.46695384761945,311268,282830,12723,295553,4.304811658145916,95.69518834185408,28.53166623237684,-1.2834861559047006
FLORIDA,FL,ALACHUA,12001,142604,89704,50972,140676,36.23361483124342,63.76638516875658,128571,75820,46834,122654,38.18383420027068,61.81616579972932,-5.107447719363489,3.1548695131715876
FLORIDA,FL,BAKER,12003,14059,2037,11911,13948,85.39575566389446,14.604244336105534,12634,2112,10294,12406,82.97597936482347,17.024020635176527,2.9162371057193104,-14.213894302213415
FLORIDA,FL,BAY,12005,93024,25614,66097,91711,72.07096204381153,27.929037956188463,87453,21797,62194,83991,74.04840994868498,25.951590051315023,-2.670479901248113,7.61975624986122
FLORIDA,FL,BRADFORD,12007,13632,3160,10334,13494,76.58218467467023,23.417815325329776,12098,2924,8913,11837,75.29779504942131,24.702204950578693,1.7057466615136851,-5.199493842021696
FLORIDA,FL,BREVARD,12009,360764,148549,207883,356432,58.32332674956233,41.67667325043767,314752,119679,181848,301527,60.309027052303776,39.690972947696224,-3.2925424265580094,5.002901554865269
FLORIDA,FL,BROWARD,12011,957672,618752,333409,952161,35.016031952579446,64.98396804742055,831951,553320,260951,814271,32.047193133489955,67.95280686651004,9.2639589580374,-4.36897157893954
FLORIDA,FL,CALHOUN,12013,6526,1209,5274,6483,81.35122628412772,18.64877371587228,6081,1241,4655,5896,78.95183175033921,21.048168249660787,3.0390612612711143,-11.39954083095651
FLORIDA,FL,CHARLOTTE,12015,116340,42273,73243,115516,63.40506942761176,36.59493057238824,96374,33445,60218,93663,64.29219649167761,35.70780350832239,-1.379836298143422,2.484406703590958
FLORIDA,FL,CITRUS,12017,93208,27092,65352,92444,70.69360910388993,29.306390896110077,79700,22789,54456,77245,70.49776684575053,29.502233154249467,0.2777992366310045,-0.6638218100828097
FLORIDA,FL,CLAY,12019,124405,38317,84480,122797,68.79646896911163,31.203531030888378,106483,27822,74963,102785,72.93184803230044,27.068151967699567,-5.670196457050302,15.277655704473503
FLORIDA,FL,COLLIER,12021,207818,77621,128950,206571,62.42405758794797,37.57594241205203,170789,61085,105423,166508,63.31407499939943,36.68592500060057,-1.4057180989533569,2.426045987492187
FLORIDA,FL,COLUMBIA,12023,33042,8914,23836,32750,72.78167938931298,27.218320610687023,28707,7601,20368,27969,72.82348314205012,27.176516857949874,-0.05740422036061288,0.15382307068876333
FLORIDA,FL,DESOTO,12027,12659,4259,8313,12572,66.12313076678333,33.876869233216674,10818,3781,6778,10559,64.19168481863812,35.80831518136187,3.0088724943147405,-5.393847597584012
FLORIDA,FL,DIXIE,12029,8167,1365,6759,8124,83.19793205317578,16.802067946824224,7202,1270,5822,7092,82.09249858996051,17.90750141003948,1.3465706151017942,-6.173018993009915
FLORIDA,FL,DUVAL,12031,492820,252556,233762,486318,48.067725233283575,51.932274766716425,432695,205704,211672,417376,50.714942881238976,49.285057118761024,-5.219798145399645,5.371237861359202
FLORIDA,FL,ESCAMBIA,12033,170372,70929,96674,167603,57.68035178367929,42.31964821632071,152469,57461,88808,146269,60.715530973753836,39.284469026246164,-4.999016135404622,7.726155565566439
FLORIDA,FL,FLAGLER,12035,71716,28161,43043,71204,60.45025560361778,39.54974439638222,57503,22026,33850,55876,60.580571264943806,39.419428735056194,-0.21511131144027473,0.3305873918211688
FLORIDA,FL,FRANKLIN,12037,6849,2120,4675,6795,68.80058866813833,31.19941133186166,6015,1744,4125,5869,70.28454591923666,29.715454080763333,-2.1113563895020837,4.993890542830326
FLORIDA,FL,GADSDEN,12039,23762,16153,7465,23618,31.607248708612076,68.39275129138792,22113,15020,6728,21748,30.93617803935994,69.06382196064006,2.169210005186595,-0.9716674377426959
FLORIDA,FL,GILCHRIST,12041,9685,1700,7895,9595,82.28243877019281,17.717561229807192,8420,1458,6740,8198,82.21517443278849,17.784825567211517,0.08181499080721633,-0.3782119602473655
FLORIDA,FL,GLADES,12043,5193,1385,3782,5167,73.1952777240178,26.804722275982193,4353,1271,2996,4267,70.213264588704,29.786735411295993,4.247079455401859,-10.011211682442156
FLORIDA,FL,GULF,12045,8163,1985,6113,8098,75.48777475919981,24.5122252408002,7293,1720,5329,7049,75.59937579798553,24.40062420201447,-0.1476216405330355,0.4573696060468535
FLORIDA,FL,HAMILTON,12047,5830,1963,3815,5778,66.02630668051229,33.973693319487715,5460,1904,3443,5347,64.39124742846455,35.60875257153544,2.5392569911993235,-4.591734149526882
FLORIDA,FL,HARDEE,12049,8485,2298,6122,8420,72.70783847980998,27.292161520190025,7583,2149,5242,7391,70.92409687457719,29.075903125422812,2.515000802036549,-6.134776270021192
FLORIDA,FL,HENDRY,12051,12940,4929,7906,12835,61.59719516945851,38.40280483054149,11115,4615,6195,10810,57.30804810360777,42.69195189639223,7.484371231936482,-10.046734513942901
FLORIDA,FL,HERNANDO,12053,108922,37519,70412,107931,65.23797611436936,34.76202388563063,93796,31795,58970,90765,64.96997741420151,35.03002258579849,0.412496218767755,-0.7650543173686297
FLORIDA,FL,HIGHLANDS,12055,52170,16938,34873,51811,67.30810059639845,32.69189940360155,45686,14937,29565,44502,66.43521639476877,33.56478360523123,1.3138877977650454,-2.600595349864343
FLORIDA,FL,HILLSBOROUGH,12057,712063,376367,327398,703765,46.52092672980327,53.47907327019673,597660,307896,266870,574766,46.431069339522516,53.568930660477484,0.19352858238883552,-0.16774161659166564
FLORIDA,FL,HOLMES,12059,9068,924,8080,9004,89.73789426921368,10.262105730786317,8514,853,7483,8336,89.767274472168907,10.232725527831095,-0.03272930266400298,0.28712001387425357
FLORIDA,FL,INDIAN RIVER,12061,97484,37844,58872,96716,60.87100376359651,39.12899623640349,80009,29043,48620,77663,62.6038139139616,37.3961860860384,-2.7678986982271447,4.633654743236026
FLORIDA,FL,JACKSON,12063,22419,6766,15488,22254,69.5964770378359,30.403522962164104,21041,6397,14257,20654,69.02779122688099,30.972208773119007,0.8238505112900807,-1.8361164201129543
FLORIDA,FL,JEFFERSON,12065,8451,3897,4479,8376,53.47421203438395,46.52578796561605,7645,3541,3930,7471,52.60339981260876,47.39660018739124,1.655429544244913,-1.8372883673771545
FLORIDA,FL,LAFAYETTE,12067,3658,510,3128,3638,85.98130841121495,14.018691588785046,3392,518,2809,3327,84.43041779380823,15.569582206191765,1.8368861103994938,-9.961029119907627
FLORIDA,FL,LAKE,12069,211314,83505,125859,209364,60.11491947039605,39.88508052960395,170462,62838,102188,165026,61.92236374874262,38.07763625125738,-2.918887731224995,4.74673445173972
FLORIDA,FL,LEE,12071,393899,157695,233247,390942,59.66281443283147,40.33718556716853,326420,124908,191551,316459,60.529484072186285,39.470515927813715,-1.4318140202900898,2.195739323346668
FLORIDA,FL,LEON,12073,162929,103517,57453,160970,35.69174380319314,64.30825619680685,152132,92068,53821,145889,36.891746464778016,63.108253535221984,-3.252767289644487,1.9014987649992987
FLORIDA,FL,LEVY,12075,23145,6205,16749,22954,72.96767447939357,27.03232552060643,19395,5101,13775,18876,72.97626615808434,27.02373384191566,-0.01177325059652512,0.031793085074882654
FLORIDA,FL,LIBERTY,12077,3561,694,2846,3540,80.3954802259887,19.6045197740113,3296,651,2543,3194,79.61803381340013,20.381966186599875,0.9764702484498233,-3.814383781578967
FLORIDA,FL,MADISON,12079,9380,3747,5576,9323,59.80907433229647,40.19092566770353,8505,3526,4851,8377,57.90855915005372,42.09144084994628,3.2819244860126773,-4.51520580874859
FLORIDA,FL,MANATEE,12081,216958,90166,124987,215153,58.092148378130915,41.907851621869085,178958,71224,101944,173168,58.869999076041765,41.130000923958235,-1.3213023783236522,1.8912002928201943
FLORIDA,FL,MARION,12083,204376,74858,127826,202684,63.06664561583549,36.93335438416451,174700,62041,107833,169874,63.478225037380646,36.521774962619354,-0.648378906786995,1.126942548565646
FLORIDA,FL,MARTIN,12085,98726,36893,61168,98061,62.377499719562316,37.622500280437684,85792,30185,53204,83389,63.80218014366403,36.19781985633597,-2.2329651132512174,3.935818316561801
FLORIDA,FL,MIAMI-DADE,12086,1156816,617864,532833,1150697,46.305239346239716,53.694760653760284,980204,624146,333999,958145,34.858920100819816,65.14107989918018,32.83612691475977,-17.571583497135045
FLORIDA,FL,MONROE,12087,48029,21881,25693,47574,54.00639004498255,45.99360995501745,42478,18971,21904,40875,53.58776758409786,46.41223241590214,0.7811903345809723,-0.9019657945633752
FLORIDA,FL,"NASSAU",12089,58811,15564,42566,58130,73.22552898675383,26.774471013246174,46607,10869,34266,45135,75.9189099368561,24.0810900631439,-3.5477076163796695,11.184630525611006
FLORIDA,FL,OKALOOSA,12091,116373,34248,79798,114046,69.97001210038054,30.029987899619453,100855,23780,71893,95673,75.14450262874583,24.855497371254167,-6.8860533337083085,20.818294042064434
FLORIDA,FL,OKEECHOBEE,12093,15954,4390,11470,15860,72.3203026481715,27.679697351828498,13653,3959,9356,13315,70.26661659782201,29.733383402177996,2.9227051902953827,-6.907004233494208
FLORIDA,FL,ORANGE,12095,647403,395014,245398,640412,38.31876979194644,61.68123020805356,546275,329894,195216,525110,37.17621069871075,62.82378930128925,3.0733608180118166,-1.8186726810702658
FLORIDA,FL,OSCEOLA,12097,172436,97297,73480,170777,43.026871299999414,56.973128700000586,140206,85458,50301,135759,37.05168718096038,62.94831281903962,16.126618174919383,-9.492206941615999
FLORIDA,FL,PALM BEACH,12099,773158,433572,334711,768283,43.566107801422135,56.433892198577865,662332,374673,272402,647075,42.09743847312908,57.90256152687092,3.488737988727064,-2.536449665722451
FLORIDA,FL,PASCO,12101,301970,119073,179621,298694,60.135456353324805,39.864543646675195,241139,90142,142101,232243,61.186343614231646,38.813656385768354,-1.7175193006015999,2.707519359840993
FLORIDA,FL,PINELLAS,12103,559715,277450,276209,553659,49.88792740658059,50.11207259341941,492403,233701,239201,472902,50.58151583203285,49.41848416796715,-1.3712290231781,1.403500000313329
FLORIDA,FL,POLK,12105,343256,145049,194586,339635,57.29268184963269,42.70731815036731,284314,117433,157430,274863,57.275806492689085,42.724193507310915,0.02946332487829828,-0.03949836277359342
FLORIDA,FL,PUTNAM,12107,36373,10527,25514,36041,70.7915984573125,29.208401542687493,33117,10094,22138,32232,68.68329610325142,31.316703896748574,3.069599849855309,-6.732197491192471
FLORIDA,FL,SANTA ROSA,12113,106928,27612,77385,104997,73.7021057744507,26.297894225549303,87745,18464,65339,83803,77.96737586959894,22.03262413040106,-5.470583109378902,19.358883762115898
FLORIDA,FL,SARASOTA,12115,270575,120110,148370,268480,55.26296185935637,44.73703814064363,229063,97870,124438,222308,55.97549345952462,44.02450654047538,-1.2729349151400893,1.6184885559436202
FLORIDA,FL,SEMINOLE,12117,260815,132528,125241,257769,48.58652514460622,51.41347485539378,224896,105914,109443,215357,50.81933719359018,49.18066280640982,-4.39362685994571,4.540020246927123
FLORIDA,FL,ST. JOHNS,12109,176622,63850,110946,174796,63.47170415798988,36.52829584201012,136514,43099,88684,131783,67.29547817245016,32.70452182754983,-5.682066787104989,11.691881736179944
FLORIDA,FL,ST. LUCIE,12111,172169,84137,86831,170968,50.787866735295495,49.212133264704505,140847,66881,70289,137170,51.24225413720201,48.75774586279799,-0.8867435860449913,0.9319286481888289
FLORIDA,FL,SUMTER,12119,92485,29341,62761,92102,68.14292849232373,31.85707150767627,76665,22638,52730,75368,69.96337968368539,30.036620316314615,-2.6020057915900896,6.060772391136382
FLORIDA,FL,SUWANNEE,12121,21057,4485,16410,20895,78.53553481694185,21.46446518305815,18694,3964,14287,18251,78.28064215659415,21.71935784340584,0.32561391082843727,-1.1735736488410087
FLORIDA,FL,TAYLOR,12123,10127,2299,7751,10050,77.12437810945273,22.875621890547265,9290,2152,6930,9082,76.30477868310945,23.695221316890553,1.0741128412770085,-3.458922857829805
FLORIDA,FL,UNION,12125,6245,1053,5133,6186,82.97769156159069,17.02230843840931,5694,1014,4568,5582,81.83446793264064,18.16553206735937,1.3969952488614767,-6.293367156606722
FLORIDA,FL,VOLUSIA,12127,307439,130575,173821,304396,57.10357560546131,42.89642439453869,260869,109091,143007,252098,56.72674912137344,43.27325087862656,0.6642835874158814,-0.8708069683620479
FLORIDA,FL,WAKULLA,12129,18404,5351,12874,18225,70.63923182441701,29.36076817558299,15351,4348,10512,14860,70.74024226110363,29.259757738896365,-0.14279062872557535,0.34521966172107454
FLORIDA,FL,WALTON,12131,43711,10338,32947,43285,76.11643756497632,23.88356243502368,33637,6876,25756,32632,78.92865898504536,21.071341014954644,-3.562991511868796,13.346191009263064
FLORIDA,FL,WASHINGTON,12133,12327,2347,9876,12223,80.7984946412501,19.2015053587499,11156,2264,8637,10901,79.23126318686359,20.76873681313641,1.9780467852573036,-7.546108694464381
GEORGIA,GA,APPLING,13001,8341,1779,6526,8305,78.57916917519566,21.420830824804334,7012,1434,5494,6928,79.3013856812933,20.698614318706696,-0.9107236902519911,3.4892021996125733
GEORGIA,GA,ATKINSON,13003,3155,825,2300,3125,73.6,26.4,2610,697,1878,2575,72.93203883495146,27.067961165048544,0.9158679446219287,-2.4677187948350165
GEORGIA,GA,BACON,13005,4668,625,4018,4643,86.53887572690071,13.461124273099289,4020,608,3364,3972,84.69284994964754,15.307150050352467,2.179671339848288,-12.059892084292144
GEORGIA,GA,BAKER,13007,1555,652,897,1549,57.9083279535184,42.0916720464816,1440,650,775,1425,54.3859649122807,45.6140350877193,6.476603011308035,-7.722103590405737
GEORGIA,GA,BALDWIN,13009,18251,9140,8903,18043,49.34323560383528,50.65676439616472,16116,7970,7697,15667,49.12874194166081,50.87125805833919,0.4365950636985083,-0.4216401763221356
GEORGIA,GA,BANKS,13011,8801,932,7795,8727,89.3204995989458,10.679500401054199,6975,684,6134,6818,89.96773247286595,10.032267527134056,-0.7194055647844033,6.451511307584101
GEORGIA,GA,BARROW,13013,37921,10453,26804,37257,71.94352739082589,28.056472609174115,29060,6580,21108,27688,76.23519214099971,23.76480785900029,-5.629506045234645,18.058907842372783
GEORGIA,GA,BARTOW,13015,50467,12092,37674,49766,75.70228670176425,24.297713298235742,39550,8212,29911,38123,78.45919785955985,21.540802140440153,-3.5138151204788026,12.798553832031324
GEORGIA,GA,BEN HILL,13017,6560,2392,4110,6502,63.21131959397108,36.78868040602892,5936,2101,3739,5840,64.02397260273973,35.976027397260275,-1.2692948839820528,2.258873665496841
GEORGIA,GA,BERRIEN,13019,7743,1269,6419,7688,83.49375650364205,16.50624349635796,6590,1047,5422,6469,83.81511825629927,16.184881743700725,-0.3834174064809237,1.9855675051954735
GEORGIA,GA,BIBB,13021,70802,43468,26585,70053,37.949837979815285,62.050162020184715,62596,36787,24043,60830,39.524905474272565,60.475094525727435,-3.9850000286085874,2.604489512268904
GEORGIA,GA,BLECKLEY,13023,5706,1311,4328,5639,76.75119702074836,23.24880297925164,4974,1101,3719,4820,77.15767634854772,22.842323651452283,-0.526816445279088,1.7795007811016283
GEORGIA,GA,BRANTLEY,13025,7746,699,6991,7690,90.91027308192457,9.089726918075423,6301,619,5567,6186,89.99353378596831,10.006466214031684,1.0186724061048036,-9.161468957650143
GEORGIA,GA,BROOKS,13027,7100,2790,4260,7050,60.42553191489362,39.57446808510638,6336,2528,3701,6229,59.415636538770265,40.584363461229735,1.6997131310111824,-2.4883854026393815
GEORGIA,GA,BRYAN,13029,21340,6739,14244,20983,67.88352475813754,32.11647524186246,15173,4014,10529,14543,72.39909234683353,27.600907653166473,-6.237049999278732,16.3602141112122
GEORGIA,GA,BULLOCH,13031,30084,11243,18386,29629,62.05406864895879,37.94593135104121,25316,9261,15097,24358,61.97963708022005,38.02036291977995,0.12009035910036658,-0.19576764402744473
GEORGIA,GA,BURKE,13033,10684,5209,5400,10609,50.90017909322273,49.09982090677727,9351,4731,4491,9222,48.69876382563435,51.30123617436565,4.520474637653105,-4.2911544277531295
GEORGIA,GA,BUTTS,13035,11771,3274,8406,11680,71.96917808219177,28.03082191780822,9514,2566,6717,9283,72.35807389852418,27.641926101475818,-0.5374601552797009,1.4069056364043986
GEORGIA,GA,CALHOUN,13037,2194,1260,923,2183,42.28126431516262,57.71873568483738,2025,1179,830,2009,41.31408661025386,58.68591338974614,2.341036155616516,-1.6480576837673455
GEORGIA,GA,CAMDEN,13039,23688,7967,15251,23218,65.68610560771815,34.31389439228185,18901,5930,12310,18240,67.4890350877193,32.5109649122807,-2.671440594250285,5.545604336462229
GEORGIA,GA,CANDLER,13043,4431,1269,3133,4402,71.17219445706498,28.827805542935028,3763,1026,2664,3690,72.1951219512195,27.804878048780488,-1.4168928128491798,3.678949759678618
GEORGIA,GA,CARROLL,13045,54474,16238,37476,53714,69.76952005063856,30.23047994936143,44121,12464,30029,42493,70.66811004165392,29.331889958346082,-1.2715636380903672,3.0635257131109705
GEORGIA,GA,CATOOSA,13047,32593,6932,25167,32099,78.40431166079941,21.5956883392006,26757,4771,20876,25647,81.39743439778532,18.602565602214685,-3.6771708581853635,16.089838364174746
GEORGIA,GA,CHARLTON,13049,4566,1103,3419,4522,75.60813799203892,24.39186200796108,4016,1004,2951,3955,74.61441213653603,25.385587863463968,1.3318148961416254,-3.914527647922228
GEORGIA,GA,CHATHAM,13051,133420,78254,53237,131491,40.48718163220296,59.51281836779704,112142,62290,45688,107978,42.312322880586784,57.687677119413216,-4.3134981114951065,3.163832103355091
GEORGIA,GA,CHATTAHOOCHEE,13053,1582,667,880,1547,56.88429217840982,43.11570782159018,1390,594,751,1345,55.8364312267658,44.1635687732342,1.876661757604814,-2.3726817844464843
GEORGIA,GA,CHATTOOGA,13055,10050,1854,8064,9918,81.30671506352087,18.693284936479127,8252,1613,6462,8075,80.02476780185758,19.975232198142415,1.6019381210045092,-6.417683904482974
GEORGIA,GA,CHEROKEE,13057,144830,42794,99587,142381,69.9440234300925,30.0559765699075,112043,25231,80649,105880,76.17019267094824,23.829807329051757,-8.174023226844795,26.12765246014055
GEORGIA,GA,CLARKE,13059,51333,36048,14446,50494,28.60933972353151,71.3906602764685,44976,29603,12717,42320,30.049621928166353,69.95037807183365,-4.793012731001545,2.059005604166697
GEORGIA,GA,CLAY,13061,1434,790,637,1427,44.639103013314646,55.360896986685354,1273,697,566,1263,44.813935075217735,55.186064924782265,-0.3901287883102511,0.3168047262318563
GEORGIA,GA,CLAYTON,13063,112344,95476,15813,111289,14.208951468698613,85.79104853130139,92859,78220,12645,90865,13.916249380949761,86.08375061905024,2.103311601684421,-0.3400201381142831
GEORGIA,GA,CLINCH,13065,2864,747,2105,2852,73.807854137447407,26.192145862552593,2455,686,1727,2413,71.57065893079155,28.429341069208455,3.1258552597918765,-7.8693178333244855
GEORGIA,GA,COBB,13067,393746,221846,165459,387305,42.72059488000413,57.27940511999587,330819,160121,152912,313033,48.84852395753802,51.15147604246198,-12.544757919114701,11.979965294543927
GEORGIA,GA,COFFEE,13069,15214,4511,10578,15089,70.10404930744251,29.89595069255749,13915,4094,9588,13682,70.07747405350095,29.92252594649905,0.03792267672386718,-0.08881353796492686
GEORGIA,GA,COLQUITT,13071,16083,4187,11777,15964,73.77223753445251,26.22776246554748,13624,3463,9898,13361,74.08128134121698,25.918718658783025,-0.4171685494221089,1.1923575807623266
GEORGIA,GA,COLUMBIA,13073,80579,29236,50013,79249,63.108682759403905,36.891317240596095,64743,18887,43085,61972,69.5233331181824,30.476666881817597,-9.22661511046121,21.047742470176377
GEORGIA,GA,COOK,13075,7035,2059,4900,6959,70.4124155769507,29.58758442304929,6057,1753,4176,5929,70.43346264125485,29.56653735874515,-0.029882194506525295,0.07118542171091757
GEORGIA,GA,COWETA,13077,76799,24210,51501,75711,68.0231406268574,31.97685937314261,61745,16583,42533,59116,71.94837269098045,28.051627309019555,-5.455623132689869,13.992885406904577
GEORGIA,GA,CRAWFORD,13079,6102,1615,4428,6043,73.27486347840477,26.725136521595235,5176,1421,3635,5056,71.89477848101266,28.105221518987342,1.9195900266339772,-4.910422059686481
GEORGIA,GA,CRISP,13081,8039,2986,4987,7973,62.548601530164305,37.451398469835695,7512,2837,4549,7386,61.5894936366098,38.4105063633902,1.5572589364241773,-2.496993620653354
GEORGIA,GA,DADE,13083,7434,1261,6066,7327,82.78968199808926,17.210318001910743,6242,965,5051,6016,83.95944148936171,16.0405585106383,-1.3932435358334994,7.292510983932665
GEORGIA,GA,DAWSON,13085,16081,2486,13398,15884,84.34903047091413,15.650969529085872,11765,1448,9900,11348,87.24004229820233,12.759957701797674,-3.3138588097036847,22.656907607780717
GEORGIA,GA,DECATUR,13087,11627,4780,6758,11538,58.57167620038135,41.42832379961865,10286,4124,6020,10144,59.345425867507885,40.654574132492115,-1.303806748061731,1.903229055124056
GEORGIA,GA,DEKALB,13089,370804,308227,58373,366600,15.922804146208401,84.0771958537916,314757,251370,51468,302838,16.995225169892812,83.00477483010718,-6.31013130431608,1.2919991962865085
GEORGIA,GA,DODGE,13091,8070,2171,5843,8014,72.90990766159221,27.090092338407786,7009,1839,5021,6860,73.19241982507289,26.807580174927114,-0.38598554898973125,1.053851789819138
GEORGIA,GA,DOOLY,13093,4105,1911,2159,4070,53.04668304668305,46.95331695331695,3859,1872,1951,3823,51.03321998430552,48.96678001569448,3.945396866975548,-4.111895986895997
GEORGIA,GA,DOUGHERTY,13095,35311,24577,10454,35031,29.84213981901744,70.15786018098255,34087,23311,10232,33543,30.504129028411292,69.4958709715887,-2.170162632007233,0.9525590515506721
GEORGIA,GA,DOUGLAS,13097,69097,42809,25451,68260,37.28537943158511,62.71462056841489,57738,31005,24817,55822,44.45738239403819,55.54261760596181,-16.132310487571257,12.912612461540252
GEORGIA,GA,EARLY,13099,5187,2437,2722,5159,52.7621632099244,47.2378367900756,4785,2168,2552,4720,54.067796610169495,45.932203389830505,-2.4148078562526765,2.842522900902611
GEORGIA,GA,ECHOLS,13101,1441,167,1256,1423,88.26423049894589,11.735769501054111,1182,156,1007,1163,86.58641444539983,13.413585554600171,1.9377359188421872,-12.508333783808123
GEORGIA,GA,EFFINGHAM,13103,31570,7720,23358,31078,75.15927665872965,24.84072334127035,23458,4853,17874,22727,78.6465437585251,21.3534562414749,-4.434100893871051,16.33115997878658
GEORGIA,GA,ELBERT,13105,9171,2879,6226,9105,68.38001098297639,31.619989017023613,7987,2539,5292,7831,67.5775762993232,32.422423700676795,1.1874274390945017,-2.474937379948039
GEORGIA,GA,EMANUEL,13107,9501,2884,6551,9435,69.43296237413884,30.567037625861154,7860,2435,5335,7770,68.66151866151866,31.338481338481337,1.1235459507139334,-2.4616499577243656
GEORGIA,GA,EVANS,13109,4247,1324,2888,4212,68.56600189933523,31.433998100664766,3613,1130,2404,3534,68.02490096208263,31.975099037917374,0.7954453877914824,-1.6922572674785141
GEORGIA,GA,FANNIN,13111,14850,2571,12169,14740,82.55766621438264,17.442333785617368,11812,1923,9632,11555,83.35785374296842,16.642146257031587,-0.9599425760806413,4.808199112225009
GEORGIA,GA,FAYETTE,13113,71993,33065,37952,71017,53.4407254601011,46.5592745398989,60913,23284,35048,58332,60.08365905506412,39.91634094493588,-11.05614022087944,16.64214063139422
GEORGIA,GA,FLOYD,13115,41648,12008,29123,41131,70.80547518903018,29.194524810969828,34608,9159,24114,33273,72.47317644937337,27.526823550626634,-2.3011289721903916,6.058458787574961
GEORGIA,GA,FORSYTH,13117,129305,42203,85122,127325,66.85411348910269,33.14588651089731,98221,23462,69851,93313,74.85666520206188,25.143334797938124,-10.690499892504912,31.82772602469357
GEORGIA,GA,FRANKLIN,13119,10765,1593,9069,10662,85.05908835115363,14.94091164884637,8502,1243,7054,8297,85.01868145112691,14.981318548873087,0.04752708385620252,-0.269715244989277
GEORGIA,GA,FULTON,13121,524659,381144,137240,518384,26.4745825488441,73.5254174511559,431391,297051,117783,414834,28.392802904294246,71.60719709570576,-6.7560091263833115,2.6788094399035955
GEORGIA,GA,GILMER,13123,16525,2932,13429,16361,82.07933500397286,17.92066499602714,12773,1965,10477,12442,84.2067191769812,15.793280823018808,-2.5263829226467194,13.470185180951466
GEORGIA,GA,GLASCOCK,13125,1566,155,1403,1558,90.05134788189987,9.948652118100128,1390,138,1235,1373,89.94901675163875,10.050983248361252,0.11376570190162472,-1.0181205931052428
GEORGIA,GA,GLYNN,13127,41984,15879,25616,41495,61.73273888420292,38.26726111579708,34263,11775,21512,33287,64.62582990356596,35.37417009643404,-4.476679098249237,8.178541041319543
GEORGIA,GA,GORDON,13129,24033,4384,19405,23789,81.57131447307579,18.42868552692421,18959,3181,15191,18372,82.68560853472675,17.314391465273243,-1.347627575581034,6.435652467982256
GEORGIA,GA,GRADY,13131,10707,3619,7034,10653,66.02834882192809,33.9716511780719,9213,3013,6053,9066,66.76593867196118,33.23406132803883,-1.1047397291260475,2.2193792168602178
GEORGIA,GA,GREENE,13133,11247,4088,7068,11156,63.35604159196845,36.64395840803155,8852,3199,5490,8689,63.18333525146737,36.81666474853263,0.27334160156902154,-0.46909827840383445
GEORGIA,GA,GWINNETT,13135,413865,241827,166413,408240,40.7635214579659,59.2364785420341,328331,166153,146989,313142,46.94004636874006,53.05995363125994,-13.158327246322122,11.64065267319665
GEORGIA,GA,HABERSHAM,13137,20432,3563,16637,20200,82.36138613861387,17.638613861386137,16243,2483,13190,15673,84.15746825751292,15.842531742487079,-2.1341921948070386,11.337090233389024
GEORGIA,GA,HALL,13139,90523,25031,64170,89201,71.93865539623995,28.06134460376005,70694,16180,51733,67913,76.17540088053833,23.824599119461663,-5.56182893076288,17.78307145087492
GEORGIA,GA,HANCOCK,13141,4165,2985,1159,4144,27.96814671814672,72.03185328185329,3580,2701,843,3544,23.78668171557562,76.21331828442437,17.579017756953697,-5.486527941174357
GEORGIA,GA,HARALSON,13143,14248,1792,12331,14123,87.3114777313602,12.688522268639808,11357,1475,9585,11060,86.66365280289331,13.33634719710669,0.7475162972189642,-4.857588955148284
GEORGIA,GA,HARRIS,13145,19991,5457,14319,19776,72.40594660194175,27.594053398058254,16502,4086,11936,16022,74.49756584696043,25.50243415303957,-2.8076343451482244,8.201645507510857
GEORGIA,GA,HART,13147,12727,3157,9464,12621,74.98613422074321,25.013865779256793,10117,2585,7286,9871,73.81217708438861,26.187822915611388,1.5904653984293526,-4.4828359353795815
GEORGIA,GA,HEARD,13149,5391,824,4516,5340,84.5692883895131,15.430711610486892,4223,743,3370,4113,81.93532701191344,18.064672988086556,3.2146834261327584,-14.580731017587379
GEORGIA,GA,HENRY,13151,122742,73276,48187,121463,39.67216353951409,60.32783646048591,98766,50057,45724,95781,47.73806913688519,52.26193086311481,-16.89617058922669,15.433615758471376
GEORGIA,GA,HOUSTON,13153,74823,32232,41534,73766,56.30507279776591,43.69492720223409,60079,22553,35430,57983,61.10411672386734,38.89588327613266,-7.853879874883985,12.338179575539376
GEORGIA,GA,IRWIN,13155,4168,1008,3134,4142,75.66393046837277,24.336069531627235,3670,891,2716,3607,75.29803160521209,24.70196839478791,0.4859341676806128,-1.4812538714035428
GEORGIA,GA,JACKSON,13157,37670,7642,29497,37139,79.42324779880988,20.576752201190125,27190,4491,21784,26275,82.90770694576594,17.092293054234062,-4.202816933817033,20.386142081111224
GEORGIA,GA,JASPER,13159,7644,1761,5822,7583,76.77700118686536,23.222998813134645,6045,1544,4360,5904,73.84823848238483,26.151761517615178,3.965920873223183,-11.199102983972198
GEORGIA,GA,JEFF DAVIS,13161,5771,1028,4695,5723,82.03739297571204,17.962607024287962,5096,901,4104,5005,81.998001998002,18.001998001998,0.04803894820633037,-0.21881447662457365
GEORGIA,GA,JEFFERSON,13163,7642,4061,3537,7598,46.55172413793103,53.44827586206897,6968,3821,3063,6884,44.494479953515395,55.505520046484605,4.623594177446044,-3.7063776408053473
GEORGIA,GA,JENKINS,13165,3455,1266,2161,3427,63.0580682812956,36.9419317187044,3056,1123,1895,3018,62.78992710404241,37.21007289595759,0.4270448933773707,-0.72061449060562
GEORGIA,GA,JOHNSON,13167,4100,1222,2850,4072,69.9901768172888,30.009823182711198,3686,1136,2519,3655,68.91928864569084,31.080711354309166,1.5538294034102895,-3.4455072774564943
GEORGIA,GA,JONES,13169,14966,4888,9965,14853,67.09082340267959,32.9091765973204,12551,3961,8305,12266,67.70748410239688,32.29251589760313,-0.9107718413885912,1.9096087207099322
GEORGIA,GA,LAMAR,13171,9039,2615,6330,8945,70.76579094466182,29.234209055338177,7612,2270,5190,7460,69.57104557640751,30.428954423592494,1.7173025909782424,-3.926343809329169
GEORGIA,GA,LANIER,13173,3576,1019,2509,3528,71.11678004535148,28.883219954648528,2871,806,1984,2790,71.11111111111111,28.88888888888889,0.007971938775508391,-0.01962323390893861
GEORGIA,GA,LAURENS,13175,22729,8073,14493,22566,64.22494017548524,35.775059824514756,19530,6752,12411,19163,64.76543338725669,35.23456661274331,-0.8345396355794232,1.5339856956718467
GEORGIA,GA,LEE,13177,16714,4558,12007,16565,72.48415333534561,27.515846664654394,14143,3170,10646,13816,77.05558772437753,22.944412275622465,-5.932644891871597,19.923955053269758
GEORGIA,GA,LIBERTY,13179,21389,13099,7959,21058,37.79561211890968,62.20438788109032,16143,9556,6134,15690,39.09496494582537,60.90503505417463,-3.3235810000500687,2.133407896013728
GEORGIA,GA,LINCOLN,13181,4650,1435,3179,4614,68.8990030342436,31.100996965756394,4102,1273,2759,4032,68.42757936507937,31.572420634920636,0.6889381058609034,-1.4931502231502192
GEORGIA,GA,LONG,13183,5656,2033,3528,5561,63.44182700953066,36.55817299046934,4117,1360,2626,3986,65.88058203712995,34.119417962870045,-3.701781241435942,7.147704073537331
GEORGIA,GA,LOWNDES,13185,46355,20117,25691,45808,56.084090115263706,43.915909884736294,37805,15064,21635,36699,58.95256001525927,41.04743998474073,-4.8657257619568846,6.988182213219418
GEORGIA,GA,LUMPKIN,13187,15531,3126,12163,15289,79.55392766040944,20.446072339590554,12425,2220,9619,11839,81.24841625137259,18.751583748627418,-2.085565072087814,9.036509201987641
GEORGIA,GA,MACON,13193,4662,2857,1783,4640,38.42672413793103,61.57327586206897,4287,2705,1540,4245,36.27797408716137,63.72202591283863,5.92301556202417,-3.372068009433349
GEORGIA,GA,MADISON,13195,14937,3411,11326,14737,76.85417656239397,23.145823437606026,11998,2425,9201,11626,79.14157921899192,20.858420781008085,-2.890266632497307,10.966327128085629
GEORGIA,GA,MARION,13197,3624,1311,2275,3586,63.44116006692694,36.55883993307306,3190,1213,1921,3134,61.29546904913848,38.70453095086152,3.500570353851651,-5.543772176215189
GEORGIA,GA,MCDUFFIE,13189,10455,4168,6169,10337,59.678823643223375,40.321176356776625,9268,3699,5432,9131,59.489650640674625,40.510349359325375,0.31799313075711044,-0.4669745029123096
GEORGIA,GA,MCINTOSH,13191,6696,2612,4016,6628,60.59143029571515,39.40856970428485,5903,2303,3487,5790,60.22452504317789,39.77547495682211,0.6092289682221752,-0.9224409084631846
GEORGIA,GA,MERIWETHER,13199,10877,4287,6524,10811,60.34594394598095,39.65405605401905,9217,3804,5222,9026,57.855085309107025,42.144914690892975,4.30534087637382,-5.910223463833864
GEORGIA,GA,MILLER,13201,2835,749,2066,2815,73.39253996447601,26.607460035523978,2544,623,1891,2514,75.21877486077963,24.781225139220364,-2.4278976886870973,7.3694294210389755
GEORGIA,GA,MITCHELL,13205,8963,3995,4935,8930,55.26315789473684,44.73684210526316,7880,3493,4279,7772,55.05661348430262,44.94338651569738,0.3751491371569937,-0.4595657480374271
GEORGIA,GA,MONROE,13207,15592,4384,11060,15444,71.61357161357161,28.386428386428385,12687,3571,8832,12403,71.20857856970088,28.79142143029912,0.5687419297020657,-1.4066448398568299
GEORGIA,GA,MONTGOMERY,13209,3966,979,2960,3939,75.14597613607515,24.854023863924855,3576,847,2670,3517,75.91697469434177,24.083025305658232,-1.0155812469751724,3.2014190430031952
GEORGIA,GA,MORGAN,13211,11707,3355,8230,11585,71.04013810962451,28.959861890375485,9475,2663,6559,9222,71.12340056386901,28.87659943613099,-0.11706759460936578,0.2883388483074345
GEORGIA,GA,MURRAY,13213,15389,2302,12943,15245,84.89996720236142,15.10003279763857,12458,1800,10341,12141,85.17420311341735,14.825796886582653,-0.321970621422496,1.8497212200721647
GEORGIA,GA,MUSCOGEE,13215,80543,49529,30049,79578,37.76043630149036,62.23956369850964,69032,39851,26976,66827,40.36691756326036,59.63308243673964,-6.456973727769267,4.3708645524655365
GEORGIA,GA,NEWTON,13217,54239,29794,23869,53663,44.47943648323798,55.52056351676202,43987,21943,20913,42856,48.798301288034345,51.201698711965655,-8.8504408776528,8.435002965608751
GEORGIA,GA,OCONEE,13219,25168,8162,16595,24757,67.03154663327544,32.96845336672456,20149,5581,13425,19006,70.63558876144376,29.364411238556244,-5.1023035149323714,12.273503796446338
GEORGIA,GA,OGLETHORPE,13221,8131,2436,5593,8029,69.65998256320837,30.34001743679163,6674,1831,4625,6456,71.63878562577447,28.361214374225526,-2.7621951506868636,6.977145042013522
GEORGIA,GA,PAULDING,13223,85385,29704,54525,84229,64.73423642688385,35.265763573116146,64890,18025,44662,62687,71.24603187263708,28.75396812736293,-9.139871056108817,22.646597564933813
GEORGIA,GA,PEACH,13225,12545,5920,6502,12422,52.34261793592014,47.65738206407986,10752,5100,5413,10513,51.48863312089794,48.51136687910206,1.6585890190889296,-1.760380854966359
GEORGIA,GA,PICKENS,13227,17116,2808,14075,16883,83.36788485458746,16.632115145412545,14038,1979,11651,13630,85.48055759354365,14.519442406456346,-2.4715242839218,14.550646504281461
GEORGIA,GA,PIERCE,13229,9048,1100,7899,8999,87.77641960217802,12.22358039782198,7311,903,6302,7205,87.46703678001388,12.53296321998612,0.35371362007181606,-2.468552861232154
GEORGIA,GA,PIKE,13231,10720,1505,9127,10632,85.8446200150489,14.155379984951091,8725,1240,7278,8518,85.44259215778352,14.557407842216483,0.4705239472638789,-2.7616720066021005
GEORGIA,GA,POLK,13233,17399,3658,13589,17247,78.7905142923407,21.209485707659304,14215,2867,11014,13881,79.34586845328147,20.654131546718535,-0.6999156626129266,2.688828429724044
GEORGIA,GA,PULASKI,13235,4059,1217,2805,4022,69.74142217802088,30.258577821979117,3605,1104,2437,3541,68.82236656311777,31.177633436882235,1.3354025163610617,-2.9478042865687892
GEORGIA,GA,PUTNAM,13237,11855,3448,8291,11739,70.62782179061249,29.372178209387513,9488,2758,6544,9302,70.35046226617932,29.649537733820683,0.39425401837978047,-0.9354598608692366
GEORGIA,GA,QUITMAN,13239,1106,497,604,1101,54.85921889191644,45.14078110808356,1044,461,575,1036,55.5019305019305,44.4980694980695,-1.1579986573470702,1.4443584120923392
GEORGIA,GA,RABUN,13241,9568,1984,7474,9458,79.02304927045887,20.97695072954113,7992,1444,6287,7731,81.32195058853965,18.678049411460353,-2.8269136456310684,12.308037458505883
GEORGIA,GA,RANDOLPH,13243,3074,1671,1391,3062,45.42782495101241,54.57217504898759,2899,1598,1271,2869,44.30115022655978,55.69884977344022,2.5432177690437596,-2.0227971116737242
GEORGIA,GA,RICHMOND,13245,87016,59124,26781,85905,31.175135323904314,68.82486467609569,75515,48814,24461,73275,33.382463323097916,66.61753667690208,-6.61223822169622,3.313433833345192
GEORGIA,GA,ROCKDALE,13247,44686,31244,13012,44256,29.40166305133767,70.59833694866232,37869,23255,13478,36733,36.691803010916615,63.308196989083385,-19.86857925027551,11.515317614930677
GEORGIA,GA,SCHLEY,13249,2275,462,1800,2262,79.57559681697613,20.424403183023873,1909,401,1472,1873,78.59049652963161,21.409503470368392,1.2534598085572668,-4.6012290229333725
GEORGIA,GA,SCREVEN,13251,6628,2661,3916,6577,59.54082408392884,40.45917591607116,5715,2300,3305,5605,58.96520963425513,41.03479036574487,0.9761933405207701,-1.4027473871396245
GEORGIA,GA,SEMINOLE,13253,3884,1254,2611,3865,67.55498059508409,32.44501940491591,3588,1189,2345,3534,66.35540464063384,33.64459535936616,1.8078044447877195,-3.5654343339168837
GEORGIA,GA,SPALDING,13255,30116,11784,18057,29841,60.510706745752486,39.489293254247514,25704,9357,15646,25003,62.576490821101466,37.423509178898534,-3.301214319056023,5.520017017842305
GEORGIA,GA,STEPHENS,13257,11885,2385,9368,11753,79.70730877222837,20.292691227771634,9815,1837,7686,9523,80.70986033812873,19.290139661871258,-1.242167390329063,5.197222951589153
GEORGIA,GA,STEWART,13259,1990,1182,801,1983,40.39334341906203,59.60665658093797,2058,1222,805,2027,39.713862851504686,60.286137148495314,1.7109405098617803,-1.1270925617338223
GEORGIA,GA,SUMTER,13261,12150,6318,5732,12050,47.56846473029046,52.43153526970954,10974,5520,5276,10796,48.869951834012596,51.130048165987404,-2.663164285781694,2.545444705033373
GEORGIA,GA,TALBOT,13263,3522,2114,1392,3506,39.70336565887051,60.29663434112949,3246,2002,1196,3198,37.39837398373984,62.60162601626016,6.163347305240707,-3.6819996888451056
GEORGIA,GA,TALIAFERRO,13265,928,561,360,921,39.08794788273616,60.91205211726384,897,545,349,894,39.038031319910516,60.961968680089484,0.1278664961780196,-0.08188148103875914
GEORGIA,GA,TATTNALL,13267,8183,2061,6053,8114,74.59945772738477,25.400542272615233,6903,1681,5096,6777,75.19551423933893,24.80448576066106,-0.7926756243158084,2.4030190252905648
GEORGIA,GA,TAYLOR,13269,3839,1387,2418,3805,63.54796320630749,36.45203679369251,3408,1296,2064,3360,61.42857142857143,38.57142857142857,3.450172661430795,-5.494719423760164
GEORGIA,GA,TELFAIR,13271,4333,1487,2825,4312,65.51484230055658,34.48515769944341,3796,1313,2450,3763,65.10762689343609,34.89237310656391,0.6254496232630302,-1.1670613686172282
GEORGIA,GA,TERRELL,13273,4416,2376,2004,4380,45.75342465753425,54.24657534246575,4189,2267,1874,4141,45.25476937937696,54.74523062062304,1.1018844753731827,-0.9108652434271391
GEORGIA,GA,THOMAS,13275,21853,8708,12954,21662,59.800572430985135,40.199427569014865,18802,7142,11228,18370,61.1213935764834,38.8786064235166,-2.160980089312714,3.397295497452135
GEORGIA,GA,TIFT,13277,16283,5322,10784,16106,66.95641375884763,33.04358624115237,14219,4347,9584,13931,68.79620989160864,31.203790108391356,-2.6742696082526773,5.896066235448272
GEORGIA,GA,TOOMBS,13279,10914,2939,7872,10811,72.81472574229952,27.185274257700492,9138,2338,6615,8953,73.88584831899922,26.11415168100078,-1.4496992334380177,4.101693938918949
GEORGIA,GA,TOWNS,13281,7979,1550,6384,7934,80.46382656919586,19.536173430804133,6764,1210,5383,6593,81.64720157743061,18.352798422569393,-1.4493760782633647,6.447926801067472
GEORGIA,GA,TREUTLEN,13283,3077,952,2101,3053,68.8175565018015,31.182443498198495,2703,862,1809,2671,67.72744290527892,32.27255709472108,1.6095596552304192,-3.3778345896888884
GEORGIA,GA,TROUP,13285,30049,11578,18143,29721,61.044379395040544,38.955620604959456,26111,9713,15750,25463,61.854455484428385,38.145544515571615,-1.3096487278782654,2.123645368483751
GEORGIA,GA,TURNER,13287,3792,1410,2349,3759,62.49002394253791,37.50997605746209,3398,1246,2095,3341,62.70577671355881,37.29422328644119,-0.34407160285481186,0.5785152552013173
GEORGIA,GA,TWIGGS,13289,4444,2044,2370,4414,53.6927956502039,46.3072043497961,4059,1971,2035,4006,50.798801797304044,49.201198202695956,5.6969726657085,-5.8819580795113175
GEORGIA,GA,UNION,13291,15560,2801,12651,15452,81.8728967123997,18.12710328760031,12063,1963,9852,11815,83.38552687261955,16.61447312738045,-1.814020030754937,9.10429207488419
GEORGIA,GA,UPSON,13293,12905,4201,8608,12809,67.20274806776486,32.79725193223515,10934,3475,7292,10767,67.72545741617907,32.27454258382093,-0.7718063020263011,1.6195716703240048
GEORGIA,GA,WALKER,13295,29354,5769,23174,28943,80.06771931036866,19.932280689631344,23956,4215,18950,23165,81.8044463630477,18.195553636952297,-2.123022806084962,9.544788179195752
GEORGIA,GA,WALTON,13297,51095,12682,37842,50524,74.89905787348587,25.10094212651413,40698,8292,31125,39417,78.96339143009361,21.036608569906385,-5.147111190387377,19.32028892918567
GEORGIA,GA,WARE,13299,14192,4211,9865,14076,70.08383063370276,29.916169366297243,12184,3440,8513,11953,71.22061407178114,28.779385928218858,-1.5961438312405596,3.949991987020618
GEORGIA,GA,WARREN,13301,2651,1469,1166,2635,44.25047438330171,55.74952561669829,2334,1314,991,2305,42.99349240780911,57.00650759219089,2.923656360757265,-2.2049797971921192
GEORGIA,GA,WASHINGTON,13303,9459,4730,4663,9393,49.64335143191739,50.35664856808261,8461,4200,4149,8349,49.694574200503055,50.305425799496945,-0.10307517351693107,0.1018235464099293
GEORGIA,GA,WAYNE,13305,12778,2687,9987,12674,78.79911630108884,21.200883698911156,10413,2041,8153,10194,79.97841867765352,20.021581322346478,-1.4745257483994023,5.890156015041814
GEORGIA,GA,WEBSTER,13307,1390,639,748,1387,53.92934390771449,46.07065609228551,1116,473,630,1103,57.116953762466004,42.883046237533996,-5.580847094906227,7.433263572496651
GEORGIA,GA,WHEELER,13309,2285,689,1583,2272,69.67429577464789,30.325704225352112,2102,646,1421,2067,68.74697629414611,31.253023705853895,1.3488876609410116,-2.9671352417913077
GEORGIA,GA,WHITE,13311,14816,2411,12222,14633,83.52354267750974,16.476457322490262,11823,1674,9761,11435,85.36073458679493,14.639265413205072,-2.152268157225301,12.549754768623744
GEORGIA,GA,WHITFIELD,13313,36746,10670,25636,36306,70.61091830551425,29.38908169448576,30658,7937,21537,29474,73.0711813801995,26.928818619800502,-3.366940328888579,9.136171584134223
GEORGIA,GA,WILCOX,13315,3281,862,2403,3265,73.59877488514549,26.40122511485452,2976,852,2096,2948,71.09905020352781,28.900949796472183,3.515834141893559,-8.64928211432966
GEORGIA,GA,WILKES,13317,5029,2160,2823,4983,56.65261890427453,43.34738109572547,4486,1848,2572,4420,58.19004524886878,41.80995475113122,-2.642077932778597,3.6771777289537733
GEORGIA,GA,WILKINSON,13319,4770,2075,2664,4739,56.214391221776744,43.785608778223256,4287,1894,2333,4227,55.19280813815945,44.80719186184055,1.8509351454994771,-2.279953376161725
GEORGIA,GA,WORTH,13321,9285,2395,6830,9225,74.03794037940379,25.962059620596207,8295,2020,6152,8172,75.2814488497308,24.718551150269214,-1.6518126169558278,5.030668920550596
HAWAII,HI,HAWAII,15001,87814,58731,26897,85628,31.411454197225208,68.58854580277479,64867,41259,17501,58760,29.783866575901975,70.21613342409803,5.464661940972126,-2.3179681676471553
HAWAII,HI,HONOLULU,15003,382102,238866,136250,375116,36.32209769777882,63.67790230222118,285790,175696,90326,266022,33.95433460390494,66.04566539609506,6.973375038842833,-3.585039350688224
HAWAII,HI,KAUAI,15007,33497,21225,11582,32807,35.303441338738686,64.69655866126132,26335,16456,7574,24030,31.51893466500208,68.48106533499792,12.007089433574158,-5.526354847465398
HAWAII,HI,MAUI,15009,71044,47305,22126,69431,31.8676095692126,68.1323904307874,51945,33480,13446,46926,28.6536248561565,71.3463751438435,11.2166775728745,-4.504762444589927
IDAHO,ID,ADA,16001,259389,120539,130699,251238,52.021987119782835,47.978012880217165,195669,75677,93752,169429,55.3340927468143,44.6659072531857,-5.985650911791895,7.415287924763314
IDAHO,ID,ADAMS,16003,2586,591,1941,2532,76.65876777251185,23.341232227488153,2183,415,1556,1971,78.94469812278031,21.055301877219687,-2.8956097174673068,10.85679209729915
IDAHO,ID,BANNOCK,16005,39553,14682,23331,38013,61.37637124141741,38.62362875858259,33416,10342,17180,27522,62.42278904149408,37.57721095850592,-1.6763393884580924,2.7847138555124884
IDAHO,ID,BEAR LAKE,16007,3315,350,2914,3264,89.27696078431373,10.723039215686274,2928,255,2203,2458,89.62571196094386,10.374288039056143,-0.3891195606703812,3.3616878123798433
IDAHO,ID,BENEWAH,16009,4973,977,3878,4855,79.87641606591143,20.12358393408857,4185,770,3103,3873,80.11877097856959,19.881229021430414,-0.3024945461569617,1.2190137360065245
IDAHO,ID,BINGHAM,16011,19996,4124,15295,19419,78.76306709923271,21.23693290076729,16625,2924,10907,13831,78.85908466488323,21.140915335116766,-0.12175840749172329,0.4541788476444486
IDAHO,ID,BLAINE,16013,13289,8919,4032,12951,31.13273106323836,68.86726893676165,10724,6416,3340,9756,34.23534235342353,65.76465764657647,-9.06259752905585,4.717748713691794
IDAHO,ID,BOISE,16015,4820,1204,3485,4689,74.3228833439966,25.677116656003413,3814,777,2673,3450,77.47826086956522,22.52173913043478,-4.072597255223254,14.0103635305171
IDAHO,ID,BONNER,16017,27335,8310,18369,26679,68.85190599347801,31.148094006521983,20943,5819,13343,19162,69.63260619977038,30.36739380022962,-1.1211704528947264,2.5708502067321337
IDAHO,ID,BONNEVILLE,16019,53995,14254,37805,52059,72.61952784340843,27.38047215659156,44221,8930,26699,35629,74.93614752027842,25.063852479721575,-3.091458199453201,9.242871496886963
IDAHO,ID,BOUNDARY,16021,6313,1220,4937,6157,80.18515510800715,19.814844891992852,5163,933,3789,4722,80.24142312579416,19.758576874205843,-0.07012340458966149,0.2847776848770245
IDAHO,ID,BUTTE,16023,1415,188,1202,1390,86.4748201438849,13.525179856115107,1230,160,914,1074,85.1024208566108,14.8975791433892,1.6126442390945073,-9.212230215827343
IDAHO,ID,CAMAS,16025,754,149,507,656,77.28658536585365,22.713414634146343,590,110,410,520,78.84615384615384,21.153846153846153,-1.9779892920880449,7.372505543237251
IDAHO,ID,CANYON,16027,90410,25881,61759,87640,70.46896394340484,29.531036056595163,72785,16883,47222,64105,73.66352078621013,26.336479213789875,-4.336687696582797,12.129779447256595
IDAHO,ID,CARIBOU,16029,3416,431,2906,3337,87.08420737189093,12.91579262810908,3035,271,2275,2546,89.35585231736057,10.644147682639435,-2.542245288424494,21.341727052272
IDAHO,ID,CASSIA,16031,9629,1464,7907,9371,84.37733432931384,15.622665670686159,8178,1036,5949,6985,85.1682176091625,14.831782390837509,-0.9286131635136807,5.33235493218418
IDAHO,ID,CLARK,16033,311,41,264,305,86.55737704918033,13.442622950819672,283,44,203,247,82.18623481781377,17.813765182186234,5.318581926835186,-24.53800298062593
IDAHO,ID,CLEARWATER,16035,4419,877,3453,4330,79.7459584295612,20.254041570438797,3801,704,2852,3556,80.20247469066366,19.797525309336333,-0.5692047070408046,2.3059258870459676
IDAHO,ID,CUSTER,16037,2739,603,2089,2692,77.6002971768202,22.39970282317979,2414,427,1777,2204,80.62613430127041,19.37386569872958,-3.7529234790592336,15.618138225499445
IDAHO,ID,ELMORE,16039,10205,2601,7246,9847,73.585863714837,26.414136285162993,8522,1814,5816,7630,76.2254259501966,23.77457404980341,-3.462836976580752,11.102458575409946
IDAHO,ID,FRANKLIN,16041,6664,657,5845,6502,89.89541679483236,10.104583205167641,5499,385,3901,4286,91.01726551563229,8.98273448436771,-1.2325669360032099,12.48894446064548
IDAHO,ID,FREMONT,16043,6719,998,5548,6546,84.75404827375496,15.245951726245035,5715,651,4090,4741,86.26871967939253,13.731280320607468,-1.7557596904957729,11.030809729842872
IDAHO,ID,GEM,16045,9958,1803,7951,9754,81.51527578429362,18.484724215706375,7954,1229,5980,7209,82.9518657234013,17.048134276598695,-1.731835597161746,8.426669545180854
IDAHO,ID,GOODING,16047,6050,1256,4659,5915,78.7658495350803,21.234150464919697,5191,930,3743,4673,80.09843783436764,19.901562165632356,-1.6636882507533368,6.695897981257781
IDAHO,ID,IDAHO,16049,9602,1561,7826,9387,83.37061894108874,16.62938105891126,8233,1196,6441,7637,84.33940028807123,15.660599711928768,-1.1486699498378106,6.186106310121486
IDAHO,ID,JEFFERSON,16051,14173,1661,12099,13760,87.92877906976744,12.071220930232558,11475,976,8436,9412,89.6302592435189,10.369740756481088,-1.8983323133414887,16.408126429660697
IDAHO,ID,JEROME,16053,7812,1893,5734,7627,75.18028058214239,24.819719417857613,6751,1329,4644,5973,77.7498744349573,22.25012556504269,-3.304949199583007,11.548671243689634
IDAHO,ID,KOOTENAI,16055,89467,24312,62837,87149,72.10295011990958,27.89704988009042,66310,16264,44449,60713,73.2116680117932,26.78833198820681,-1.5144005347686118,4.138808987329656
IDAHO,ID,LATAH,16057,20570,10236,9472,19708,48.061700832149384,51.938299167850616,18173,8093,7265,15358,47.304336502148715,52.695663497851285,1.6010463014659804,-1.4372422315767075
IDAHO,ID,LEMHI,16059,4738,1032,3592,4624,77.68166089965398,22.31833910034602,4096,733,3011,3744,80.42200854700855,19.57799145299145,-3.4074598444687854,13.997082662613236
IDAHO,ID,LEWIS,16061,1870,349,1489,1838,81.01196953210011,18.98803046789989,1590,270,1202,1472,81.65760869565217,18.342391304347824,-0.7906662635180028,3.519929069439409
IDAHO,ID,LINCOLN,16063,1940,414,1469,1883,78.0138077535847,21.986192246415296,1748,360,1184,1544,76.6839378238342,23.316062176165804,1.7342222732557255,-5.703664365374406
IDAHO,ID,MADISON,16065,17112,2666,13559,16225,83.56856702619415,16.431432973805855,15688,1201,8941,10142,88.15815421021495,11.841845789785053,-5.206083572345255,38.75736321427059
IDAHO,ID,MINIDOKA,16067,7993,1550,6265,7815,80.16634676903391,19.833653230966092,6871,1167,4887,6054,80.72348860257681,19.276511397423192,-0.6901855249168642,2.8902627765798883
IDAHO,ID,NEZ PERCE,16069,20967,6686,13738,20424,67.26400313356835,32.73599686643165,17201,4828,10699,15527,68.90577703355446,31.094222966445546,-2.382636073005351,5.279996550348831
IDAHO,ID,ONEIDA,16071,2451,249,2148,2397,89.61201501877346,10.387984981226532,2068,184,1531,1715,89.27113702623906,10.728862973760933,0.38184569379262623,-3.177205202154876
IDAHO,ID,OWYHEE,16073,4742,816,3819,4635,82.3948220064725,17.60517799352751,3925,591,3052,3643,83.77710678012627,16.22289321987373,-1.6499552524314232,8.520581100542678
IDAHO,ID,PAYETTE,16075,11293,2161,8862,11023,80.39553660527987,19.60446339472013,8704,1507,6489,7996,81.15307653826913,18.846923461730867,-0.9334703812886591,4.019435503770508
IDAHO,ID,POWER,16077,3074,865,2116,2981,70.98289164709828,29.01710835290171,2758,699,1666,2365,70.44397463002115,29.556025369978858,0.7650292589360452,-1.8233744569205346
IDAHO,ID,SHOSHONE,16079,6049,1693,4216,5909,71.34878998138433,28.65121001861567,5120,1384,3297,4681,70.43366801965392,29.56633198034608,1.2992677897664562,-3.0951487737428063
IDAHO,ID,TETON,16081,6347,3318,2858,6176,46.27590673575129,53.72409326424871,4976,2159,2167,4326,50.09246417013407,49.90753582986593,-7.619025132044255,7.647256813867487
IDAHO,ID,TWIN FALLS,16083,36501,9391,25897,35288,73.38755384266607,26.612446157333938,29874,6233,19828,26061,76.08303595410767,23.91696404589233,-3.5428161845006856,11.27016834690835
IDAHO,ID,VALLEY,16085,7063,2976,3947,6923,57.01285569839665,42.98714430160335,5349,1913,2906,4819,60.302967420626686,39.697032579373314,-5.455969851832954,8.28805456844044
IDAHO,ID,WASHINGTON,16087,5344,1073,4154,5227,79.47197245073656,20.528027549263438,4455,776,3283,4059,80.8819906380882,19.118009361911803,-1.7433030223759638,7.375339977397277
ILLINOIS,IL,ADAMS,17001,33527,8633,24220,32853,73.72233890360089,26.27766109639911,31951,7676,22790,30466,74.80470032167005,25.195299678329942,-1.446916321320546,4.295886264056192
ILLINOIS,IL,ALEXANDER,17003,2618,1114,1486,2600,57.15384615384615,42.84615384615385,2846,1262,1496,2758,54.2422044960116,45.7577955039884,5.367852735499801,-6.363159819578201
ILLINOIS,IL,BOND,17005,8145,2288,5625,7913,71.08555541513964,28.914444584860355,7530,2068,4888,6956,70.27027027027027,29.72972972972973,1.1602134753910143,-2.74232276001517
ILLINOIS,IL,BOONE,17007,24979,10542,13883,24425,56.83930399181167,43.16069600818833,23001,8986,12282,21268,57.748730487116795,42.251269512883205,-1.5747991126974004,2.152424071015968
ILLINOIS,IL,BROWN,17009,2521,486,1931,2417,79.89242863053371,20.10757136946628,2379,476,1796,2272,79.04929577464789,20.950704225352112,1.066591229717484,-4.024365228093707
ILLINOIS,IL,BUREAU,17011,17434,6669,10411,17080,60.95433255269321,39.04566744730679,16571,6029,9281,15310,60.62050947093403,39.37949052906597,0.5506768001005247,-0.8477079750759731
ILLINOIS,IL,CALHOUN,17013,2772,677,2046,2723,75.13771575468233,24.862284245317664,2571,739,1721,2460,69.95934959349593,30.040650406504064,7.4019644140142615,-17.237862999348508
ILLINOIS,IL,CARROLL,17015,8024,2748,5105,7853,65.00700369285623,34.99299630714377,7445,2447,4434,6881,64.4383083854091,35.561691614590906,0.8825422666990823,-1.5991795711253531
ILLINOIS,IL,CASS,17017,5317,1615,3625,5240,69.1793893129771,30.8206106870229,5124,1621,3216,4837,66.4874922472607,33.5125077527393,4.048727023280518,-8.032514563152526
ILLINOIS,IL,CHAMPAIGN,17019,95142,57067,35285,92352,38.20707726957727,61.79292273042273,91628,50137,33368,83505,39.959283875217054,60.040716124782946,-4.384979998919625,2.9183639348973944
ILLINOIS,IL,CHRISTIAN,17021,16204,4335,11563,15898,72.73241917222292,27.267580827777078,15459,3992,10543,14535,72.53525971792226,27.464740282077745,0.2718118816522841,-0.7178638948547644
ILLINOIS,IL,CLARK,17023,8356,1993,6226,8219,75.75130794500548,24.248692054994525,7928,1877,5622,7499,74.96999599946659,25.030004000533406,1.0421661827812345,-3.121501480871647
ILLINOIS,IL,CLAY,17025,6886,1129,5629,6758,83.2938739271974,16.706126072802604,6350,1020,5021,6041,83.11537824863433,16.884621751365668,0.21475650153346404,-1.0571494060779063
ILLINOIS,IL,CLINTON,17027,19170,4493,14304,18797,76.09724956110017,23.902750438899826,17419,3945,12412,16357,75.8818854313138,24.118114568686188,0.28381494287106346,-0.8929559115121721
ILLINOIS,IL,COLES,17029,22606,8067,14037,22104,63.5043431053203,36.4956568946797,21863,7309,13003,20312,64.01634501772351,35.983654982276484,-0.7997987268118067,1.4228735592740627
ILLINOIS,IL,COOK,17031,2321486,1725973,558269,2284242,24.44001117219629,75.5599888278037,2158615,1611946,453287,2065233,21.948467800001257,78.05153219999875,11.351787263231605,-3.1921774012209303
ILLINOIS,IL,CRAWFORD,17033,9425,2202,7043,9245,76.18171984856679,23.818280151433207,8728,1992,6277,8269,75.91002539605756,24.089974603942437,0.35791642947247126,-1.127832042067678
ILLINOIS,IL,CUMBERLAND,17035,5832,1142,4601,5743,80.11492251436532,19.885077485634685,5567,1031,4206,5237,80.3131563872446,19.686843612755393,-0.24682615127646912,1.0069357829959769
ILLINOIS,IL,DE WITT,17039,8024,2191,5632,7823,71.99284162086157,28.00715837913844,7543,1910,5077,6987,72.6635179619293,27.336482038070702,-0.9229890870672164,2.45341130630381
ILLINOIS,IL,DEKALB,17037,47825,24643,21905,46548,47.05894990117728,52.94105009882272,43600,20466,19091,39557,48.2620016684784,51.7379983315216,-2.4927514933282935,2.3252769842240895
ILLINOIS,IL,DOUGLAS,17041,8738,2335,6227,8562,72.72833450128475,27.271665498715254,8169,1949,5698,7647,74.51288086831437,25.487119131685628,-2.3949501700027187,7.0017578597616925
ILLINOIS,IL,DUPAGE,17043,485104,281222,193611,474833,40.77454599827729,59.22545400172271,428769,228622,166415,395037,42.126433726461066,57.873566273538934,-3.209119805777927,2.3359329919191207
ILLINOIS,IL,EDGAR,17045,8196,1887,6193,8080,76.64603960396039,23.353960396039604,7873,1793,5645,7438,75.8940575423501,24.105942457649906,0.990831279762161,-3.1194883292010256
ILLINOIS,IL,EDWARDS,17047,3366,488,2833,3321,85.30563083408612,14.694369165913882,3347,434,2778,3212,86.4881693648817,13.511830635118306,-1.3672835712438491,8.751875025150667
ILLINOIS,IL,EFFINGHAM,17049,19049,3716,15006,18722,80.15169319517146,19.848306804828542,17609,3083,13635,16718,81.55879889938988,18.441201100610122,-1.7252653584982514,7.6302280775619735
ILLINOIS,IL,FAYETTE,17051,10056,1826,8055,9881,81.52008905981177,18.47991094018824,9585,1819,7372,9191,80.20890001088021,19.79109998911979,1.6347176544668773,-6.6251448866024525
ILLINOIS,IL,FORD,17053,6953,1754,5048,6802,74.21346662746251,25.786533372537487,6396,1414,4480,5894,76.00950118764845,23.990498812351543,-2.362907968244632,7.486441087507756
ILLINOIS,IL,FRANKLIN,17055,18626,4760,13622,18382,74.1051028179741,25.894897182025893,18711,4727,13116,17843,73.50781819200807,26.49218180799193,0.8125457137169612,-2.254569405777873
ILLINOIS,IL,FULTON,17057,16678,6503,9867,16370,60.274893097128896,39.725106902871104,15797,6133,8492,14625,58.064957264957265,41.935042735042735,3.805971684586673,-5.269902420595162
ILLINOIS,IL,GALLATIN,17059,2674,622,2019,2641,76.44831503218478,23.55168496781522,2707,657,1942,2599,74.72104655636784,25.278953443632165,2.3116224349372994,-6.832832220164753
ILLINOIS,IL,GREENE,17061,6227,1349,4770,6119,77.95391403824155,22.046085961758457,5585,1205,4145,5350,77.4766355140187,22.523364485981308,0.6160289757761728,-2.1190374311968907
ILLINOIS,IL,GRUNDY,17063,26691,9626,16523,26149,63.187884813950824,36.812115186049176,23237,8065,13454,21519,62.5214926344161,37.4785073655839,1.065860956697473,-1.7780648867213533
ILLINOIS,IL,HAMILTON,17065,4315,824,3432,4256,80.6390977443609,19.360902255639097,4166,802,3206,4008,79.99001996007983,20.00998003992016,0.8114484589514914,-3.243770273564206
ILLINOIS,IL,HANCOCK,17067,9383,2315,6906,9221,74.894263095109,25.10573690489101,9121,2139,6430,8569,75.03792741276695,24.96207258723305,-0.19145560466733436,0.5755304058022714
ILLINOIS,IL,HARDIN,17069,2162,449,1691,2140,79.01869158878505,20.981308411214954,2148,420,1653,2073,79.73950795947901,20.260492040520983,-0.9039639058975202,3.5577436582109545
ILLINOIS,IL,HENDERSON,17071,3647,1187,2394,3581,66.85283440379783,33.14716559620218,3518,1155,2155,3310,65.10574018126889,34.894259818731115,2.6834718684783265,-5.006824135559118
ILLINOIS,IL,HENRY,17073,25635,9797,15300,25097,60.963461768338846,39.036538231661154,24643,8871,13985,22856,61.18743437171859,38.81256562828141,-0.36604346248462205,0.577062092531544
ILLINOIS,IL,IROQUOIS,17075,14025,2908,10877,13785,78.90460645629307,21.095393543706926,13064,2504,9750,12254,79.56585604700506,20.43414395299494,-0.8310720497009982,3.2360033884124118
ILLINOIS,IL,JACKSON,17077,22643,11181,10890,22071,49.34076389832812,50.65923610167188,24617,11634,10843,22477,48.24042354406727,51.75957645593273,2.2809508570249104,-2.1258681573595672
ILLINOIS,IL,JASPER,17079,5576,1007,4494,5501,81.69423741137975,18.30576258862025,5136,924,3975,4899,81.13900796080833,18.86099203919167,0.6842941077608522,-2.943797703841333
ILLINOIS,IL,JEFFERSON,17081,17404,4608,12476,17084,73.02739405291501,26.972605947084993,16999,4425,11695,16120,72.54962779156328,27.450372208436725,0.6585371640008386,-1.7404727984158042
ILLINOIS,IL,JERSEY,17083,11937,2961,8712,11673,74.6337702390131,25.366229760986894,10991,2679,7748,10427,74.30708736932962,25.692912630670374,0.43963891096923113,-1.2714902135832928
ILLINOIS,IL,JO DAVIESS,17085,12496,5109,7166,12275,58.378818737270876,41.621181262729124,11334,4462,6121,10583,57.838042143059624,42.161957856940376,0.9349842667109476,-1.2826173681169117
ILLINOIS,IL,JOHNSON,17087,6437,1281,5059,6340,79.79495268138801,20.20504731861199,6089,1142,4649,5791,80.27974443101364,19.720255568986357,-0.6038780430376423,2.4583441524361094
ILLINOIS,IL,KANE,17089,231876,130166,96775,226941,42.64324207613433,57.35675792386567,199314,103665,82734,186399,44.38543125231359,55.61456874768641,-3.9251374314143828,3.1326129383170587
ILLINOIS,IL,KANKAKEE,17091,49902,20271,28532,48803,58.463619039813125,41.536380960186875,47305,18971,25129,44100,56.981859410430836,43.018140589569164,2.6004058918285278,-3.4444994810900242
ILLINOIS,IL,KENDALL,17093,63974,33168,29492,62660,47.066709224385576,52.933290775614424,53447,24884,24961,49845,50.07723944227104,49.92276055772896,-6.011773515103602,6.030376093493861
ILLINOIS,IL,KNOX,17095,23143,10703,12009,22712,52.87513208876365,47.12486791123635,22243,10083,10737,20820,51.570605187319885,48.429394812680115,2.5295939357417474,-2.6936675679915867
ILLINOIS,IL,LAKE,17097,334177,204032,123594,327626,37.72411224994353,62.27588775005647,303520,171095,109767,280862,39.08218270894603,60.91781729105397,-3.4749094468862207,2.229348521326502
ILLINOIS,IL,LASALLE,17099,53591,22442,30113,52555,57.29806868994387,42.70193131005613,49743,19543,26689,46232,57.72841322028032,42.27158677971968,-0.7454639861559031,1.0180467853714958
ILLINOIS,IL,LAWRENCE,17101,6411,1419,4886,6305,77.49405233941316,22.505947660586838,6094,1290,4521,5811,77.80072276716572,22.19927723283428,-0.3941742657974201,1.3814432989690761
ILLINOIS,IL,LEE,17103,16397,6407,9630,16037,60.048637525721766,39.951362474278234,15489,5528,8612,14140,60.90523338048091,39.09476661951909,-1.4064404768107552,2.191075504032969
ILLINOIS,IL,LIVINGSTON,17105,17174,4615,12208,16823,72.56731855198241,27.432681448017593,15269,4023,10208,14231,71.7307286908861,28.269271309113908,1.1662921545123162,-2.9593612511214618
ILLINOIS,IL,LOGAN,17107,13294,3840,9136,12976,70.40690505548706,29.59309494451295,12401,3313,8181,11494,71.17626587784932,28.823734122150686,-1.0809232724889095,2.6691920592308627
ILLINOIS,IL,MACON,17115,49390,19847,28589,48436,59.02427946155752,40.97572053844248,48060,18343,26866,45209,59.42622044283218,40.57377955716782,-0.6763697544273861,0.9906421971567436
ILLINOIS,IL,MACOUPIN,17117,24022,7365,16153,23518,68.68356152734076,31.31643847265924,22360,6689,14322,21011,68.16429489315121,31.835705106848792,0.7617868489705693,-1.6310825610639346
ILLINOIS,IL,MADISON,17119,137139,57836,76031,133867,56.795924312937466,43.204075687062534,130179,50587,70490,121077,58.21914979723647,41.78085020276353,-2.4446002548229595,3.40640623010795
ILLINOIS,IL,MARION,17121,17458,4524,12678,17202,73.70073247296826,26.29926752703174,17074,4369,11859,16228,73.07739709144688,26.922602908553117,0.8529797260586003,-2.315286466314692
ILLINOIS,IL,MARSHALL,17123,6334,2005,4197,6202,67.67171880038697,32.32828119961303,5984,1789,3785,5574,67.90455687118765,32.09544312881234,-0.3428901999056766,0.7254552300967276
ILLINOIS,IL,MASON,17125,6766,1985,4654,6639,70.10091881307426,29.89908118692574,6486,2014,4058,6072,66.83135704874836,33.16864295125165,4.892257031292968,-9.857387801880291
ILLINOIS,IL,MASSAC,17127,6813,1725,4997,6722,74.33799464445106,25.662005355548942,6683,1558,4846,6404,75.67145534041224,24.328544659587756,-1.762171336552909,5.48105410586357
ILLINOIS,IL,MCDONOUGH,17109,12285,4992,7027,12019,58.46576254264082,41.53423745735918,13092,5288,6795,12083,56.23603409749234,43.76396590250766,3.9649461078335557,-5.094895764510021
ILLINOIS,IL,MCHENRY,17111,163879,78154,82260,160414,51.27981348261374,48.72018651738626,141750,60803,71612,132415,54.08148623645357,45.91851376354643,-5.180465532308853,6.101401208817014
ILLINOIS,IL,MCLEAN,17113,87002,43933,40502,84435,47.968259607982475,52.031740392017525,79835,36196,37237,73433,50.70880939087331,49.29119060912669,-5.404484577356472,5.559918007708675
ILLINOIS,IL,MENARD,17129,6928,2022,4764,6786,70.20335985853227,29.796640141467726,6515,1817,4231,6048,69.95701058201058,30.042989417989418,0.35214380156065594,-0.8199892264189268
ILLINOIS,IL,MERCER,17131,8893,3280,5418,8698,62.290181650954246,37.709818349045754,8525,3071,4807,7878,61.018024879411016,38.981975120588984,2.0848868413184007,-3.2634487288236924
ILLINOIS,IL,MONROE,17133,21148,6569,14142,20711,68.28255516392255,31.717444836077448,19354,5535,12629,18164,69.52763708434266,30.472362915657346,-1.7907726662848011,4.085938211835716
ILLINOIS,IL,MONTGOMERY,17135,13727,3905,9544,13449,70.96438396906834,29.035616030931667,12978,3504,8630,12134,71.1224657985825,28.877534201417504,-0.22226708219290625,0.5474214952411183
ILLINOIS,IL,MORGAN,17137,15309,5076,9950,15026,66.21855450552376,33.781445494476245,14800,4696,9076,13772,65.90182979959337,34.09817020040662,0.4806007767819809,-0.9288612968639587
ILLINOIS,IL,MOULTRIE,17139,6744,1662,4964,6626,74.91699366133413,25.08300633866586,6283,1481,4455,5936,75.05053908355795,24.94946091644205,-0.1779406568620856,0.5352637584878694
ILLINOIS,IL,OGLE,17141,26272,9428,16248,25676,63.28088487303318,36.71911512696682,24193,8050,14352,22402,64.06570841889118,35.93429158110883,-1.225029060361682,2.1840518104733864
ILLINOIS,IL,PEORIA,17143,83973,43578,38252,81830,46.745692288891604,53.254307711108396,78503,38060,35633,73693,48.35330357021698,51.64669642978302,-3.324718607883448,3.1127088322309815
ILLINOIS,IL,PERRY,17145,10053,2612,7313,9925,73.68261964735517,26.317380352644836,9853,2462,6855,9317,73.57518514543308,26.42481485456692,0.14602002252488422,-0.4065667158440589
ILLINOIS,IL,PIATT,17147,9822,3329,6248,9577,65.23963662942467,34.760363370575334,9008,2645,5634,8279,68.0516970648629,31.948302935137093,-4.132241452785445,8.801908637048461
ILLINOIS,IL,PIKE,17149,7949,1484,6332,7816,81.01330603889457,18.986693961105424,7530,1413,5754,7167,80.2846379238175,19.715362076182505,0.9076059055886931,-3.695940821484389
ILLINOIS,IL,POPE,17151,2175,433,1722,2155,79.90719257540603,20.092807424593968,2142,375,1678,2053,81.73404773502192,18.265952264978083,-2.2351213603643783,10.001423047177106
ILLINOIS,IL,PULASKI,17153,2624,891,1699,2590,65.5984555984556,34.4015444015444,2735,962,1675,2637,63.51915054986728,36.48084945013272,3.2735089033596454,-5.699716645662589
ILLINOIS,IL,PUTNAM,17155,3390,1338,1993,3331,59.83188231762234,40.16811768237766,3111,1147,1767,2914,60.638297872340424,39.361702127659576,-1.329878283219299,2.0487314092837883
ILLINOIS,IL,RANDOLPH,17157,14891,3592,11076,14668,75.5113171529861,24.48868284701391,14194,3439,10023,13462,74.45401871935819,25.545981280641808,1.4200689926667565,-4.138805325239536
ILLINOIS,IL,RICHLAND,17159,8063,1830,6089,7919,76.89102159363556,23.10897840636444,7684,1584,5739,7323,78.36952068824252,21.630479311757476,-1.8865741191508523,6.835258124878019
ILLINOIS,IL,ROCK ISLAND,17161,66758,36691,28603,65294,43.80647532698257,56.19352467301743,63994,32298,26998,59296,45.530895844576364,54.469104155423636,-3.7873634717846327,3.1658690634479347
ILLINOIS,IL,SALINE,17165,11066,2789,8103,10892,74.39405067939772,25.605949320602278,11384,2572,8276,10848,76.2905604719764,23.709439528023598,-2.4859036043853977,7.998965097159227
ILLINOIS,IL,SANGAMON,17167,104752,48917,53485,102402,52.230425187008066,47.769574812991934,98373,40907,49944,90851,54.97352808444596,45.02647191555404,-4.989861471550738,6.092200389545321
ILLINOIS,IL,SCHUYLER,17169,3906,1068,2773,3841,72.19474095287686,27.805259047123144,3828,1075,2524,3599,70.13059183106418,29.869408168935816,2.9432934585593484,-6.910579245957027
ILLINOIS,IL,SCOTT,17171,2737,572,2114,2686,78.70439314966492,21.29560685033507,2608,535,1966,2501,78.60855657736906,21.391443422630946,0.12191620921260249,-0.4480135837607202
ILLINOIS,IL,SHELBY,17173,12097,2504,9426,11930,79.01089689857503,20.98910310142498,11010,2288,8229,10517,78.24474660074165,21.755253399258343,0.9791715496796138,-3.521679494018126
ILLINOIS,IL,ST. CLAIR,17163,128091,68325,57150,125475,45.546921697549315,54.453078302450685,120580,60756,53857,114613,46.990306509732754,53.009693490267246,-3.07166502922146,2.7228695680884263
ILLINOIS,IL,STARK,17175,2883,815,2004,2819,71.08903866619369,28.910961333806313,2743,751,1778,2529,70.30446816923686,29.695531830763148,1.1159610724430946,-2.6420489837601036
ILLINOIS,IL,STEPHENSON,17177,22048,9055,12521,21576,58.03207267334075,41.96792732665925,20343,7768,11083,18851,58.79263699538486,41.20736300461514,-1.2936387291214935,1.8457000559801262
ILLINOIS,IL,TAZEWELL,17179,69052,24819,42513,67332,63.13936909641775,36.86063090358225,64400,20685,38707,59392,65.1720770474138,34.827922952586206,-3.1189859876910364,5.836431744044335
ILLINOIS,IL,UNION,17181,8886,2579,6161,8740,70.49199084668192,29.508009153318078,8537,2402,5790,8192,70.6787109375,29.3212890625,-0.2641815170952966,0.6368072372946232
ILLINOIS,IL,VERMILION,17183,31584,10323,20725,31048,66.75148157691316,33.248518423086836,30570,10039,19087,29126,65.53251390510196,34.46748609489803,1.8600960029953928,-3.5365726077470683
ILLINOIS,IL,WABASH,17185,5593,1253,4237,5490,77.17668488160291,22.823315118397087,5464,1151,4047,5198,77.85686802616391,22.14313197383609,-0.873632810829772,3.071756720615171
ILLINOIS,IL,WARREN,17187,7909,3090,4676,7766,60.21117692505794,39.78882307494206,7807,2987,4275,7262,58.86808041861746,41.13191958138254,2.2815361005311674,-3.265338744483015
ILLINOIS,IL,WASHINGTON,17189,7902,1641,6115,7756,78.84218669417226,21.157813305827748,7427,1448,5571,7019,79.37028066676164,20.629719333238352,-0.6653548005034815,2.5598698850862966
ILLINOIS,IL,WAYNE,17191,8486,1187,7176,8363,85.80652875762286,14.193471242377138,8261,1048,6967,8015,86.92451653150343,13.07548346849657,-1.286159323618885,8.550259549286988
ILLINOIS,IL,WHITE,17193,7421,1517,5791,7308,79.24192665571977,20.75807334428024,7335,1412,5640,7052,79.97731140102098,20.022688598979013,-0.9194917063588992,3.6727572406970665
ILLINOIS,IL,WHITESIDE,17195,27375,12253,14527,26780,54.24570575056012,45.75429424943988,25582,11035,12615,23650,53.34038054968288,46.65961945031712,1.6972604836105187,-1.9402755777749747
ILLINOIS,IL,WILL,17197,345105,183915,155116,339031,45.75274827375668,54.24725172624332,300904,151927,132720,284647,46.62617206575162,53.37382793424838,-1.8732479062687046,1.6364271138111341
ILLINOIS,IL,WILLIAMSON,17199,33653,10206,22801,33007,69.07928621201563,30.92071378798437,31852,8581,21570,30151,71.53991575735465,28.46008424264535,-3.4395197691940993,8.64589691428932
ILLINOIS,IL,WINNEBAGO,17201,127709,64056,60861,124917,48.721150844160526,51.278849155839474,118376,55713,55624,111337,49.96003125645563,50.03996874354437,-2.4797430688857314,2.475781746875949
ILLINOIS,IL,WOODFORD,17203,21432,6160,14799,20959,70.60928479412186,29.39071520587814,19864,5092,13207,18299,72.17334280561779,27.826657194382207,-2.167085451076245,5.620718293865701
INDIANA,IN,ADAMS,18001,14209,3236,10686,13922,76.75621318776038,23.24378681223962,13090,2805,9648,12453,77.47530715490244,22.524692845097565,-0.928158910947352,3.1924695803279945
INDIANA,IN,ALLEN,18003,169082,73189,92083,165272,55.716031753715086,44.283968246284914,147137,55382,83930,139312,60.2460663833697,39.7539336166303,-7.5192205924752065,11.39518587856061
INDIANA,IN,BARTHOLOMEW,18005,36235,12934,22410,35344,63.40538705296514,36.59461294703486,32490,9841,20640,30481,67.71431383484794,32.285686165152065,-6.363391339077995,13.3462450196697
INDIANA,IN,BENTON,18007,4114,1009,3007,4016,74.87549800796813,25.124501992031874,3666,860,2579,3439,74.99273044489678,25.00726955510323,-0.1563250680874817,0.46879343092744996
INDIANA,IN,BLACKFORD,18009,5351,1376,3841,5217,73.62468851830553,26.37531148169446,4839,1243,3350,4593,72.93707816242107,27.062921837578923,0.9427445864409911,-2.5407838813977013
INDIANA,IN,BOONE,18011,38520,15244,22351,37595,59.45205479452055,40.54794520547945,32178,10181,19654,29835,65.87564940506117,34.12435059493883,-9.75109113694308,18.824078696147662
INDIANA,IN,BROWN,18013,8981,3036,5777,8813,65.55089072960399,34.44910927039601,7945,2518,5016,7534,66.57817892221927,33.42182107778073,-1.5429803116354557,3.073705021113393
INDIANA,IN,CARROLL,18015,9495,2224,7086,9310,76.11170784103115,23.888292158968852,8643,1892,6273,8165,76.82792406613595,23.172075933864054,-0.9322342544206497,3.090859132125101
INDIANA,IN,CASS,18017,15198,4304,10552,14856,71.02854065697362,28.971459343026385,14209,3759,9701,13460,72.07280832095097,27.927191679049034,-1.4489065825311953,3.739250533954541
INDIANA,IN,CLARK,18019,57869,23093,33668,56761,59.31537499339335,40.68462500660665,51147,18808,30035,48843,61.49294678869029,38.50705321130971,-3.541173271106657,5.6549946404555795
INDIANA,IN,CLAY,18021,12267,2552,9499,12051,78.82333416313999,21.17666583686001,11282,2306,8531,10837,78.72104826058873,21.278951739411276,0.12993462969734804,-0.4806905142879736
INDIANA,IN,CLINTON,18023,12949,3361,9334,12695,73.52500984639622,26.47499015360378,11936,2819,8531,11350,75.16299559471365,24.837004405286343,-2.1792449001761693,6.594940845478159
INDIANA,IN,CRAWFORD,18025,4944,1355,3483,4838,71.99255890863994,28.007441091360064,4593,1323,3015,4338,69.50207468879668,30.497925311203318,3.583323564072982,-8.166077509962232
INDIANA,IN,DAVIESS,18027,11954,2169,9576,11745,81.53256704980843,18.467432950191572,10768,1800,8545,10345,82.60028999516675,17.399710004833253,-1.292638252748013,6.136441038739893
INDIANA,IN,DEARBORN,18029,25383,5446,19528,24974,78.19332105389606,21.806678946103947,23987,4883,18113,22996,78.76587232562184,21.234127674378154,-0.7269027242646775,2.6963729356146438
INDIANA,IN,DECATUR,18031,12287,2439,9575,12014,79.6986848676544,20.301315132345596,11127,2121,8490,10611,80.01130901894261,19.988690981057392,-0.39072495516127015,1.5640051246200493
INDIANA,IN,DEKALB,18033,19628,4966,14237,19203,74.1394573764516,25.860542623548405,16902,3942,12054,15996,75.3563390847712,24.643660915228807,-1.6148365527028474,4.937909641369931
INDIANA,IN,DELAWARE,18035,48191,20474,26827,47301,56.715502843491684,43.284497156508316,45123,18153,24263,42416,57.20247076574877,42.79752923425123,-0.8513057491017828,1.1378412047847064
INDIANA,IN,DUBOIS,18037,21770,6292,15033,21325,70.4947245017585,29.5052754982415,19984,5389,13365,18754,71.2647968433401,28.735203156659914,-1.0805788772181968,2.6798917598851446
INDIANA,IN,ELKHART,18039,74387,26108,46972,73080,64.27476737821566,35.72523262178434,65630,20740,41867,62607,66.8727139137796,33.127286086220394,-3.8849126699322167,7.842316236839553
INDIANA,IN,FAYETTE,18041,10136,2237,7755,9992,77.6120896717374,22.38791032826261,9530,2252,6839,9091,75.22824771752282,24.771752282477177,3.168812283340361,-9.623227000783585
INDIANA,IN,FLOYD,18043,41802,17511,23400,40911,57.197330791229746,42.802669208770254,37425,13945,21432,35377,60.581733894903465,39.418266105096535,-5.586507493405435,8.585875123604536
INDIANA,IN,FOUNTAIN,18045,7986,1629,6154,7783,79.06976744186046,20.930232558139537,7492,1476,5662,7138,79.32193891846455,20.678061081535443,-0.31790886612503844,1.2195121951219745
INDIANA,IN,FRANKLIN,18047,12000,2137,9691,11828,81.93270206290158,18.06729793709841,11013,1969,8669,10638,81.49088174468885,18.509118255311147,0.5421714782728237,-2.387041414498281
INDIANA,IN,FULTON,18049,9147,2280,6694,8974,74.59326944506351,25.406730554936484,8374,1960,6010,7970,75.4077791718946,24.592220828105397,-1.0801401868292482,3.3120625116549895
INDIANA,IN,GIBSON,18051,16161,4023,11817,15840,74.60227272727273,25.397727272727273,15484,3721,11081,14802,74.86150520199973,25.13849479800027,-0.3462827444191907,1.0312171703598771
INDIANA,IN,GRANT,18053,27159,8015,18543,26558,69.8207696362678,30.17923036373221,25312,7010,17008,24018,70.8135564992922,29.186443500707803,-1.4019728878245652,3.401534219132696
INDIANA,IN,GREENE,18055,14784,3389,11103,14492,76.61468396356611,23.385316036433895,13801,2929,10277,13206,77.82068756625776,22.17931243374224,-1.5497210836962094,5.437515731357467
INDIANA,IN,HAMILTON,18057,193999,88390,101587,189977,53.47331519078625,46.52668480921375,154256,57263,87404,144667,60.41737231020205,39.58262768979795,-11.493477544443332,17.543193882516196
INDIANA,IN,HANCOCK,18059,42911,12895,28996,41891,69.21773173235302,30.782268267646987,36181,8904,25074,33978,73.79480840543881,26.205191594561185,-6.202437233712576,17.46629730436988
INDIANA,IN,HARRISON,18061,20236,5343,14565,19908,73.16154309825195,26.838456901748042,18558,4783,12943,17726,73.0170371206138,26.98296287938621,0.19790720540941997,-0.5355452560347418
INDIANA,IN,HENDRICKS,18063,88505,32604,53802,86406,62.26650927018957,37.73349072981043,75559,22600,48337,70937,68.14074460436726,31.859255395632744,-8.620738397098748,18.438081057547006
INDIANA,IN,HENRY,18065,21030,5544,15043,20587,73.07038422305338,26.929615776946616,20155,5124,13895,19019,73.05852042694148,26.94147957305852,0.016238757700759443,-0.04403542901099122
INDIANA,IN,HOWARD,18067,40630,13303,26449,39752,66.53501710605755,33.46498289394244,36843,11215,23675,34890,67.8561192318716,32.143880768128405,-1.9469167125513054,4.109964616108042
INDIANA,IN,HUNTINGTON,18069,17829,4255,13147,17402,75.54878749569015,24.45121250430985,16043,3506,11649,15155,76.86572088419663,23.134279115803366,-1.7132908835793437,5.692562892987962
INDIANA,IN,JACKSON,18071,19238,4302,14555,18857,77.18619080447579,22.813809195524207,17573,3843,12859,16702,76.9907795473596,23.009220452640402,0.25381124631422836,-0.8492736966834946
INDIANA,IN,JASPER,18073,15475,3798,11383,15181,74.98188525130097,25.01811474869903,13378,3329,9382,12711,73.81008575249784,26.189914247502163,1.587587233989174,-4.474239540188229
INDIANA,IN,JAY,18075,8461,1926,6361,8287,76.75877881018462,23.241221189815374,7986,1889,5697,7586,75.09886633271816,24.901133667281837,2.2103029759628967,-6.666011674992367
INDIANA,IN,JEFFERSON,18077,14697,4731,9663,14394,67.13213839099625,32.867861609003754,13544,4326,8546,12872,66.39216904909883,33.60783095090118,1.1145431042480336,-2.201776553144641
INDIANA,IN,JENNINGS,18079,12251,2523,9490,12013,78.99775243486224,21.00224756513777,11150,2364,8224,10588,77.67283717415943,22.327162825840574,1.7057639567511274,-5.934095930761973
INDIANA,IN,JOHNSON,18081,77618,24736,51219,75955,67.43334869330525,32.56665130669475,66500,17318,45456,62774,72.41214515563769,27.587854844362315,-6.875637300388437,18.04705907878834
INDIANA,IN,KNOX,18083,16011,4067,11655,15722,74.13178984861977,25.868210151380232,15516,3772,11077,14849,74.59761600107751,25.402383998922485,-0.6244517954179796,1.8337891139568185
INDIANA,IN,KOSCIUSKO,18085,35787,8364,26499,34863,76.00894931589364,23.99105068410636,32084,6313,23935,30248,79.12919862470245,20.87080137529754,-3.943233803753865,14.950309059535737
INDIANA,IN,LAGRANGE,18087,10633,2355,8110,10465,77.49641662685141,22.50358337314859,9566,2080,7025,9105,77.1554091158704,22.844590884129598,0.4419748594280737,-1.4927275901356118
INDIANA,IN,LAKE,18089,219956,124870,91760,216630,42.3579374971149,57.6420625028851,201205,116935,75625,192560,39.27347320315746,60.72652679684254,7.853810835629016,-5.079270059814811
INDIANA,IN,LAPORTE,18091,49392,22427,25997,48424,53.68618866677681,46.31381133322319,45203,19798,22687,42485,53.40002353771919,46.59997646228081,0.5358895185794799,-0.6140885699572052
INDIANA,IN,LAWRENCE,18093,21025,4961,15601,20562,75.87296955549071,24.127030444509288,19152,4210,14035,18245,76.9251849821869,23.074815017813098,-1.367842569296196,4.5600167363591515
INDIANA,IN,MADISON,18095,51793,19524,31215,50739,61.520723703659904,38.479276296340096,53909,18595,32376,50971,63.518471287594906,36.481528712405094,-3.1451443075349306,5.476052277534338
INDIANA,IN,MARION,18097,389619,247772,134175,381947,35.129219499040445,64.87078050095955,362372,212899,130360,343259,37.97715427709106,62.02284572290894,-7.49907367274375,4.591751224659935
INDIANA,IN,MARSHALL,18099,19927,5712,13844,19556,70.7915729187973,29.2084270812027,18082,4798,12288,17086,71.91852979047174,28.08147020952827,-1.5669909757022649,4.013169051569254
INDIANA,IN,MARTIN,18101,5144,1011,4029,5040,79.94047619047619,20.05952380952381,4809,881,3697,4578,80.75578855395369,19.244211446046307,-1.009602380308361,4.2366628830874165
INDIANA,IN,MIAMI,18103,14473,3235,10925,14160,77.15395480225989,22.846045197740114,13482,2766,9975,12741,78.2905580409701,21.709441959029903,-1.4517756255044367,5.235524896748656
INDIANA,IN,MONROE,18105,63151,39861,22071,61932,35.63747335787638,64.36252664212363,58454,34216,20592,54808,37.571157495256166,62.428842504743834,-5.146724951510839,3.0974210954381576
INDIANA,IN,MONTGOMERY,18107,17198,4213,12659,16872,75.02963489805595,24.97036510194405,15156,3362,11059,14421,76.68677622911032,23.313223770889675,-2.1609218858065993,7.108160361432225
INDIANA,IN,MORGAN,18109,36159,7781,27512,35293,77.95313518261412,22.046864817385885,31280,6040,23674,29714,79.67288147001413,20.327118529985864,-2.1585089627356613,8.46035450062983
INDIANA,IN,NEWTON,18111,6591,1509,4942,6451,76.6082777863897,23.391722213610294,5795,1404,4077,5481,74.38423645320196,25.61576354679803,2.989936361835177,-8.68231520455981
INDIANA,IN,NOBLE,18113,19190,4660,14195,18855,75.2850702731371,24.714929726862902,16890,3904,12198,16102,75.754564650354,24.245435349646005,-0.6197572111777849,1.9364237863592315
INDIANA,IN,OHIO,18115,3075,668,2054,2722,75.4592211609111,24.540778839088905,2921,686,2118,2804,75.53495007132668,24.465049928673324,-0.10025678224989676,0.30953916152374195
INDIANA,IN,ORANGE,18117,8832,2224,6432,8656,74.3068391866913,25.693160813308687,8192,2048,5803,7851,73.91415106355878,26.085848936441216,0.5312759701384673,-1.5053683860905664
INDIANA,IN,OWEN,18119,9904,2420,7286,9706,75.06696888522563,24.933031114774366,8557,1946,6153,8099,75.97234226447709,24.027657735522904,-1.1917144480022013,3.768046761848698
INDIANA,IN,PARKE,18121,7013,1503,5400,6903,78.22685788787484,21.773142112125164,6582,1441,4863,6304,77.14149746192894,22.858502538071065,1.4069734989025307,-4.748169413714754
INDIANA,IN,PERRY,18123,8722,3203,5345,8548,62.529246607393546,37.470753392606454,8055,3062,4556,7618,59.80572328695195,40.19427671304805,4.553950977858667,-6.775898319766183
INDIANA,IN,PIKE,18125,6220,1415,4692,6107,76.82986736531849,23.17013263468151,5977,1297,4398,5695,77.22563652326602,22.774363476733978,-0.5124841642817568,1.7377836195151986
INDIANA,IN,PORTER,18127,86509,39746,45008,84754,53.104278264152725,46.895721735847275,77190,33676,38832,72508,53.55546974126993,46.44453025873007,-0.8424750623922117,0.9714631079348557
INDIANA,IN,POSEY,18129,13236,3811,9206,13017,70.722900822002,29.277099177998004,12467,3521,8404,11925,70.47379454926624,29.52620545073375,0.3534736199873878,-0.8436785863032648
INDIANA,IN,PULASKI,18131,5806,1463,4246,5709,74.373795761079,25.626204238921,5459,1327,3854,5181,74.38718394132407,25.612816058675932,-0.017997966229821305,0.05227141058756768
INDIANA,IN,PUTNAM,18133,16597,3946,12278,16224,75.67800788954635,24.32199211045365,14715,3356,10637,13993,76.01657971843065,23.983420281569355,-0.4453920843826231,1.4116911804463506
INDIANA,IN,RANDOLPH,18135,11070,2513,8312,10825,76.78521939953811,23.214780600461893,10458,2446,7517,9963,75.4491618990264,24.550838100973603,1.7708049591057984,-5.4420036294350655
INDIANA,IN,RIPLEY,18137,14271,2774,11261,14035,80.23512646954043,19.764873530459564,12810,2471,9806,12277,79.87293312698542,20.12706687301458,0.4534619280591512,-1.7995336570408527
INDIANA,IN,RUSH,18139,7932,1754,6035,7789,77.48106303761715,22.51893696238285,7214,1525,5292,6817,77.62945577233387,22.37054422766613,-0.19115519133861003,0.6633398508615551
INDIANA,IN,SCOTT,18143,10167,2701,7331,10032,73.0761562998405,26.92384370015949,9101,2642,6074,8716,69.68793024323084,30.31206975676916,4.861998404578505,-11.177811623546507
INDIANA,IN,SHELBY,18145,19991,5023,14568,19591,74.36067582052983,25.639324179470165,17994,4247,12718,16965,74.96610669024462,25.033893309755378,-0.8076061255473554,2.4184447150250366
INDIANA,IN,SPENCER,18147,10769,3213,7357,10570,69.60264900662251,30.397350993377483,9979,2861,6572,9433,69.67030637124986,30.32969362875013,-0.0971107608840227,0.2230730236035594
INDIANA,IN,ST. JOSEPH,18141,115238,59896,53164,113060,47.02281974173005,52.97718025826995,110060,52252,52021,104273,49.88923307088125,50.11076692911875,-5.745555007988745,5.720154579166015
INDIANA,IN,STARKE,18149,10290,2650,7466,10116,73.80387504942665,26.19612495057335,9226,2489,6367,8856,71.89476061427281,28.10523938572719,2.6554291562309373,-6.792735009129136
INDIANA,IN,STEUBEN,18151,16162,4513,11327,15840,71.50883838383838,28.491161616161616,14566,3744,10133,13877,73.02010521005981,26.97989478994019,-2.069658516478312,5.601455594945182
INDIANA,IN,SULLIVAN,18153,8994,2153,6691,8844,75.6558118498417,24.3441881501583,8559,2113,6138,8251,74.39098291116228,25.609017088837717,1.7002449613952253,-4.938998378156123
INDIANA,IN,SWITZERLAND,18155,4154,964,3133,4097,76.47058823529412,23.529411764705884,3699,930,2558,3488,73.33715596330275,26.662844036697248,4.272639470174311,-11.752055660974058
INDIANA,IN,TIPPECANOE,18157,71448,35017,34581,69598,49.68677260840829,50.31322739159171,62515,27282,30768,58050,53.002583979328165,46.997416020671835,-6.255942865376318,7.055305699065273
INDIANA,IN,TIPTON,18159,8116,1834,6110,7944,76.91339375629406,23.08660624370594,7510,1587,5589,7176,77.88461538461539,22.115384615384617,-1.2470006092026975,4.391610841105109
INDIANA,IN,UNION,18161,3483,736,2688,3424,78.50467289719626,21.49532710280374,3291,715,2445,3160,77.37341772151899,22.626582278481013,1.4620721288916894,-4.999673223972289
INDIANA,IN,VANDERBURGH,18163,77662,34415,41844,76259,54.870900483877314,45.129099516122686,72507,28530,40496,69026,58.667748384666645,41.332251615333355,-6.471780501775093,9.18616274798052
INDIANA,IN,VERMILLION,18165,7481,2145,5184,7329,70.73270568972575,29.267294310274252,6939,2081,4513,6594,68.44100697603882,31.558993023961175,3.348429274994813,-7.261634463263611
INDIANA,IN,VIGO,18167,43594,18123,24545,42668,57.5255460766851,42.4744539233149,39818,15931,21937,37868,57.930178514841025,42.069821485158975,-0.6984829816332416,0.9618116356844064
INDIANA,IN,WABASH,18169,14576,3494,10762,14256,75.49102132435466,24.50897867564534,13468,3018,9821,12839,76.4934963782226,23.506503621777398,-1.3105363218216537,4.264671045927937
INDIANA,IN,WARREN,18171,4472,974,3401,4375,77.73714285714286,22.262857142857143,3930,839,2898,3737,77.54883596467755,22.451164035322453,0.24282362220249265,-0.8387399965945952
INDIANA,IN,WARRICK,18173,33829,11923,21326,33249,64.14027489548558,35.859725104514425,29589,9086,19113,28199,67.77899925529275,32.22100074470726,-5.368512960927241,11.293020935747556
INDIANA,IN,WASHINGTON,18175,12139,2784,9114,11898,76.60110943015633,23.398890569843672,11382,2636,8209,10845,75.69386814200092,24.306131857999077,1.1985664234432258,-3.7325613695164517
INDIANA,IN,WAYNE,18177,27679,9524,17567,27091,64.84441327378096,35.15558672621904,25579,8322,16028,24350,65.82340862422998,34.17659137577002,-1.487305763877822,2.864520161431572
INDIANA,IN,WELLS,18179,14050,2928,10855,13783,78.75643909163462,21.243560908365378,13185,2586,10005,12591,79.46152013342864,20.53847986657136,-0.887323877783952,3.4329757916583326
INDIANA,IN,WHITE,18181,11166,3032,7957,10989,72.4087724087724,27.59122759122759,10053,2590,6893,9483,72.68796794263419,27.312032057365812,-0.3841014431468559,1.0222437249464145
INDIANA,IN,WHITLEY,18183,17556,4234,12862,17096,75.23397285914834,24.766027140851662,15623,3379,11358,14737,77.07131709303114,22.928682906968852,-2.3839533346302955,8.013300377250943
IOWA,IA,ADAIR,19001,4177,1198,2922,4120,70.92233009708738,29.07766990291262,3811,1133,2461,3594,68.47523650528659,31.52476349471341,3.573691332357609,-7.762448692790858
IOWA,IA,ADAMS,19003,2160,590,1535,2125,72.23529411764706,27.764705882352942,2106,565,1395,1960,71.1734693877551,28.8265306122449,1.4918827746152274,-3.683498178032274
IOWA,IA,ALLAMAKEE,19005,7422,2576,4744,7320,64.80874316939891,35.19125683060109,6923,2421,4093,6514,62.83389622351857,37.16610377648143,3.1429643306778665,-5.313570014648706
IOWA,IA,APPANOOSE,19007,6516,1891,4522,6413,70.51302042725713,29.486979572742865,6136,1814,4033,5847,68.9755430135112,31.024456986488797,2.229018209316247,-4.955694839124847
IOWA,IA,AUDUBON,19009,3420,1071,2299,3370,68.21958456973294,31.780415430267063,3412,1080,2136,3216,66.41791044776119,33.582089552238806,2.712632947687821,-5.36498516320475
IOWA,IA,BENTON,19011,14642,5160,9208,14368,64.08685968819599,35.91314031180401,13844,4678,8232,12910,63.76452362509682,36.23547637490318,0.5055100309293348,-0.8895593361715082
IOWA,IA,BLACK HAWK,19013,66593,35647,29813,65460,45.543843568591505,54.456156431408495,64405,32233,27476,59709,46.016513423437004,53.983486576562996,-1.0271744199654154,0.875582302701261
IOWA,IA,BOONE,19015,15340,6303,8729,15032,58.069451836083026,41.930548163916974,14196,5541,7484,13025,57.45873320537428,42.54126679462572,1.0628821706281988,-1.4355910783218628
IOWA,IA,BREMER,19017,14546,5958,8324,14282,58.28315361994118,41.71684638005882,13538,5356,7208,12564,57.370264247055076,42.629735752944924,1.591223929098362,-2.141438028555087
IOWA,IA,BUCHANAN,19019,10774,4169,6430,10599,60.666100575525995,39.333899424474005,10252,3970,5510,9480,58.12236286919831,41.87763713080169,4.376521498364139,-6.074214976319004
IOWA,IA,BUENA VISTA,19021,8167,2961,5074,8035,63.148724331051646,36.851275668948354,8278,2856,4903,7759,63.19113287794819,36.80886712205181,-0.06711154708756162,0.11521285552180682
IOWA,IA,BUTLER,19023,8098,2424,5556,7980,69.62406015037594,30.37593984962406,7513,2157,4921,7078,69.52528962983894,30.474710370161063,0.14206416264193056,-0.3241065110620722
IOWA,IA,CALHOUN,19025,5258,1470,3698,5168,71.55572755417957,28.444272445820435,5159,1398,3468,4866,71.27003699136868,28.72996300863132,0.4008564817294502,-0.9943993409426088
IOWA,IA,CARROLL,19027,11335,3454,7766,11220,69.2156862745098,30.784313725490197,10544,3309,6638,9947,66.73368854931135,33.26631145068865,3.719257513189067,-7.460994672876698
IOWA,IA,CASS,19029,7276,2201,4979,7180,69.34540389972145,30.654596100278553,7125,1951,4761,6712,70.93265792610251,29.067342073897496,-2.2376914566413997,5.460609443910647
IOWA,IA,CEDAR,19031,10703,4337,6184,10521,58.77768272977854,41.22231727022146,9541,3599,5295,8894,59.5345176523499,40.4654823476501,-1.2712539757034236,1.8703222565572775
IOWA,IA,CERRO GORDO,19033,23801,10941,12499,23440,53.32337883959045,46.67662116040955,22965,9862,11621,21483,54.09393473909603,45.90606526090397,-1.4244774450631104,1.6785492181178752
IOWA,IA,CHEROKEE,19035,6518,1936,4510,6446,69.96587030716724,30.034129692832764,6258,1679,4192,5871,71.40180548458525,28.59819451541475,-2.0110628403199327,5.0210693428357045
IOWA,IA,CHICKASAW,19037,6631,2233,4322,6555,65.93440122044241,34.06559877955759,6435,2266,3742,6008,62.28362183754993,37.71637816245007,5.861539960560669,-9.679559811305394
IOWA,IA,CLARKE,19039,4670,1466,3153,4619,68.26152846936566,31.738471530634335,4454,1465,2713,4178,64.93537577788416,35.064624222115846,5.122250624773206,-9.485778802054433
IOWA,IA,CLAY,19041,8969,2662,6158,8820,69.81859410430839,30.18140589569161,8617,2249,5877,8126,72.32340634998769,27.676593650012308,-3.463349380362435,9.050290933032468
IOWA,IA,CLAYTON,19043,9594,3340,6119,9459,64.68971350037002,35.31028649962998,9129,3237,5317,8554,62.1580547112462,37.8419452887538,4.07293761184222,-6.690086278086227
IOWA,IA,CLINTON,19045,24687,10812,13410,24222,55.36289323755264,44.63710676244736,23067,10095,11276,21371,52.7630901689205,47.2369098310795,4.9273138861065435,-5.503753479914564
IOWA,IA,CRAWFORD,19047,7154,2220,4862,7082,68.65292290313471,31.34707709686529,6935,1991,4617,6608,69.86985472154964,30.130145278450364,-1.7417122495312687,4.038917858405755
IOWA,IA,DALLAS,19049,56022,26879,28162,55041,51.16549481295761,48.83450518704239,38252,15701,19339,35040,55.1912100456621,44.8087899543379,-7.294123881998315,8.98420876084105
IOWA,IA,DAVIS,19051,4102,1013,3035,4048,74.97529644268775,25.024703557312254,3882,977,2723,3700,73.5945945945946,26.405405405405407,1.87609138374758,-5.228860632491983
IOWA,IA,DECATUR,19053,3804,1120,2618,3738,70.0374531835206,29.9625468164794,3734,1201,2296,3497,65.65627680869316,34.343723191306836,6.672897989011983,-12.756847446104535
IOWA,IA,DELAWARE,19055,10003,3157,6688,9845,67.93296089385476,32.06703910614525,9241,2957,5694,8651,65.81898046468616,34.18101953531384,3.2118097458267547,-6.184661715501328
IOWA,IA,DES MOINES,19057,19956,8893,10642,19535,54.47658049654466,45.52341950345534,19103,8212,9529,17741,53.71174116453413,46.28825883546587,1.4239704679608334,-1.6523398184606464
IOWA,IA,DICKINSON,19059,11244,3661,7452,11113,67.05660037793575,32.94339962206425,10354,3056,6753,9809,68.84493832194923,31.15506167805077,-2.5976317033656438,5.7401200565537325
IOWA,IA,DUBUQUE,19061,53926,25657,27358,53015,51.60426294444969,48.39573705555031,49721,22850,23460,46310,50.65860505290434,49.34139494709566,1.8667270655355894,-1.9165609171757025
IOWA,IA,EMMET,19063,4853,1520,3268,4788,68.25396825396825,31.746031746031747,4753,1357,3124,4481,69.71658112028565,30.28341887971435,-2.0979411824482264,4.829748160625091
IOWA,IA,FAYETTE,19065,10186,3835,6174,10009,61.68448396443201,38.31551603556799,9975,3689,5620,9309,60.3716833172199,39.6283166827801,2.174530467063618,-3.3127842843311384
IOWA,IA,FLOYD,19067,8032,3172,4747,7919,59.94443742896831,40.05556257103169,8060,3179,4375,7554,57.91633571617686,42.08366428382314,3.5017783630689303,-4.8192136956359155
IOWA,IA,FRANKLIN,19069,5130,1626,3433,5059,67.85926072346314,32.14073927653686,4968,1493,3163,4656,67.93384879725086,32.06615120274914,-0.10979515382726346,0.2326068798095271
IOWA,IA,FREMONT,19071,3857,1080,2717,3797,71.55649196734264,28.443508032657363,3595,963,2407,3370,71.42433234421365,28.57566765578635,0.18503445365378735,-0.4624900622478556
IOWA,IA,GREENE,19073,5057,1769,3229,4998,64.60584233693477,35.39415766306523,4821,1691,2820,4511,62.513855021059634,37.48614497894037,3.3464378659264993,-5.580694726145918
IOWA,IA,GRUNDY,19075,7276,2206,4945,7151,69.1511676688575,30.848832331142496,6872,1856,4527,6383,70.92276359078804,29.07723640921197,-2.497922856126056,6.0927245526306795
IOWA,IA,GUTHRIE,19077,6371,1985,4280,6265,68.31604150039904,31.68395849960096,5750,1732,3628,5360,67.68656716417911,32.3134328358209,0.9299841350989047,-1.9480268141679358
IOWA,IA,HAMILTON,19079,7943,2843,4982,7825,63.66773162939297,36.33226837060703,7694,2726,4463,7189,62.08095701766588,37.91904298233412,2.555976402354032,-4.1846378150058765
IOWA,IA,HANCOCK,19081,6172,1683,4401,6084,72.33727810650888,27.662721893491124,5871,1587,3977,5564,71.47735442127966,28.522645578720343,1.2030715073209297,-3.014880519606411
IOWA,IA,HARDIN,19083,8989,2976,5864,8840,66.33484162895928,33.665158371040725,8533,2787,5254,8041,65.34013182439995,34.65986817560005,1.5223565927791505,-2.8699180259998402
IOWA,IA,HARRISON,19085,8155,2440,5580,8020,69.57605985037407,30.423940149625935,7465,2131,4902,7033,69.69998578131666,30.30001421868335,-0.17779907636051862,0.40899627983068676
IOWA,IA,HENRY,19087,9982,3275,6525,9800,66.58163265306122,33.41836734693877,9404,2904,5779,8683,66.55533801681446,33.44466198318553,0.039507929837445666,-0.07862132456288862
IOWA,IA,HOWARD,19089,4958,1772,3133,4905,63.87359836901121,36.12640163098879,4559,1677,2611,4288,60.89085820895522,39.10914179104478,4.8985024152891965,-7.626708292379303
IOWA,IA,HUMBOLDT,19091,5327,1442,3825,5267,72.62198595025632,27.378014049743687,5087,1252,3568,4820,74.02489626556017,25.975103734439834,-1.8951871411896248,5.400980606840711
IOWA,IA,IDA,19093,3849,917,2885,3802,75.88111520252498,24.118884797475012,3612,792,2655,3447,77.02349869451697,22.97650130548303,-1.4831622963828228,4.971964516283278
IOWA,IA,IOWA,19095,9742,3547,6035,9582,62.98267585055312,37.01732414944688,8904,3084,5205,8289,62.794064422728916,37.205935577271084,0.30036505768200605,-0.5069390808154495
IOWA,IA,JACKSON,19097,11135,4029,6957,10986,63.32605133806663,36.67394866193337,10310,3837,5824,9661,60.283614532657076,39.716385467342924,5.046871905402073,-7.660407082893316
IOWA,IA,JASPER,19099,20184,7737,12125,19862,61.04621891048233,38.95378108951767,19034,7109,10560,17669,59.76569132378742,40.23430867621258,2.14257972815457,-3.1826757531737693
IOWA,IA,JEFFERSON,19101,8959,4319,4476,8795,50.892552586696986,49.107447413303014,8156,3710,3748,7458,50.25475998927326,49.74524001072674,1.2691187811062266,-1.2821178413978784
IOWA,IA,JOHNSON,19103,83851,59177,23206,82383,28.16843280773946,71.83156719226054,76940,50200,21044,71244,29.53792600078603,70.46207399921397,-4.6363891392040335,1.9435891044902398
IOWA,IA,JONES,19105,10989,4213,6596,10809,61.02322138958276,38.97677861041724,10133,3787,5720,9507,60.16619333122962,39.83380666877038,1.4244345718117613,-2.1515093083610437
IOWA,IA,KEOKUK,19107,5303,1414,3809,5223,72.92743633926862,27.07256366073138,4985,1342,3390,4732,71.63989856297549,28.360101437024515,1.797235621657567,-4.5399618162586535
IOWA,IA,KOSSUTH,19109,9090,2696,6288,8984,69.99109528049867,30.008904719501334,8607,2543,5653,8196,68.97266959492435,31.027330405075645,1.476564110908729,-3.282350341709417
IOWA,IA,LEE,19111,16734,6541,9808,16349,59.99143678512447,40.00856321487553,16151,6215,8803,15018,58.616327074177654,41.383672925822346,2.3459499760308145,-3.3228314785195945
IOWA,IA,LINN,19113,127458,70874,53744,124618,43.12699610008185,56.87300389991815,117098,58935,48390,107325,45.08735150244584,54.91264849755416,-4.347905425887899,3.569952380736674
IOWA,IA,LOUISA,19115,5332,1726,3506,5232,67.01070336391437,32.989296636085626,5008,1648,3069,4717,65.062539749841,34.937460250159,2.994293831079875,-5.576145490038897
IOWA,IA,LUCAS,19117,4630,1284,3295,4579,71.95894300065517,28.041056999344836,4354,1239,2877,4116,69.89795918367346,30.102040816326532,2.948560789258492,-6.846658103871395
IOWA,IA,LYON,19119,6863,1067,5718,6785,84.27413411938099,15.725865880619013,6377,920,5192,6112,84.94764397905759,15.052356020942408,-0.7928529010676755,4.474448111242846
IOWA,IA,MADISON,19121,9824,3134,6525,9659,67.55357697484212,32.446423025157884,8636,2678,5360,8038,66.68325454093058,33.31674545906942,1.3051589036904732,-2.6122672605604746
IOWA,IA,MAHASKA,19123,11404,2894,8320,11214,74.19297306937756,25.807026930622435,10632,2619,7432,10051,73.94289125460153,26.05710874539847,0.33820940800777244,-0.9597450631210092
IOWA,IA,MARION,19125,19232,6178,12722,18900,67.31216931216932,32.68783068783069,17816,5482,10962,16444,66.66261250304062,33.33738749695938,0.9743944690122408,-1.9484334493455213
IOWA,IA,MARSHALL,19127,18136,8176,9610,17786,54.03126054199932,45.96873945800068,17980,7652,9146,16798,54.44695797118705,45.55304202881295,-0.7634906424114796,0.912556902181838
IOWA,IA,MILLS,19129,8268,2508,5616,8124,69.12850812407682,30.87149187592319,7698,2090,5067,7157,70.79782031577477,29.202179684225236,-2.357858171695726,5.7163958641063495
IOWA,IA,MITCHELL,19131,5822,2053,3684,5737,64.21474638312706,35.78525361687293,5417,1888,3190,5078,62.82000787711698,37.17999212288302,2.220213834959006,-3.751314689364016
IOWA,IA,MONONA,19133,4728,1407,3262,4669,69.86506746626686,30.134932533733135,4572,1247,3120,4367,71.44492786810167,28.555072131898328,-2.2112981970553225,5.532678728799212
IOWA,IA,MONROE,19135,4088,1078,2978,4056,73.42209072978304,26.577909270216963,3865,1056,2638,3694,71.41310232809963,28.586897671900378,2.8131930082708534,-7.0276545036160325
IOWA,IA,MONTGOMERY,19137,5327,1583,3666,5249,69.84187464278911,30.158125357210896,5044,1314,3436,4750,72.33684210526316,27.66315789473684,-3.4490964629661613,9.019098513509704
IOWA,IA,MUSCATINE,19139,20671,9372,10865,20237,53.68878786381381,46.31121213618619,19434,8368,9584,17952,53.386809269162214,46.613190730837786,0.5656427098482242,-0.6478393560211959
IOWA,IA,O'BRIEN,19141,7551,1569,5871,7440,78.91129032258064,21.088709677419356,7406,1315,5752,7067,81.39238715154946,18.607612848450543,-3.048315592893358,13.333772844351778
IOWA,IA,OSCEOLA,19143,3328,601,2695,3296,81.76577669902913,18.234223300970875,3213,552,2531,3083,82.09536166072007,17.904638339279924,-0.4014659964018841,1.8407797769804501
IOWA,IA,PAGE,19145,7528,2086,5328,7414,71.86404100350688,28.13595899649312,7044,1807,4893,6700,73.02985074626865,26.970149253731343,-1.5963468785006762,4.32259284809291
IOWA,IA,PALO ALTO,19147,4958,1519,3378,4897,68.98100878088626,31.018991219113744,4703,1398,3081,4479,68.78767582049565,31.212324179504353,0.28105755585507985,-0.6194122529252777
IOWA,IA,PLYMOUTH,19149,14188,3494,10515,14009,75.058890713113,24.941109286887002,13190,2885,9680,12565,77.03939514524473,22.96060485475527,-2.5707684080304882,8.625663150688112
IOWA,IA,POCAHONTAS,19151,3823,933,2832,3765,75.2191235059761,24.780876494023904,3865,963,2702,3665,73.7244201909959,26.275579809004093,2.0274195593643407,-5.688564537281815
IOWA,IA,POLK,19153,258755,146250,107564,253814,42.37906498459502,57.62093501540498,231555,119804,93492,213296,43.8320456079814,56.1679543920186,-3.3148820759618114,2.586849813410419
IOWA,IA,POTTAWATTAMIE,19155,45744,18575,26352,44927,58.65515169052018,41.34484830947982,42680,15355,24447,39802,61.421536606200696,38.578463393799304,-4.503933096654644,7.170801199213028
IOWA,IA,POWESHIEK,19157,10140,4306,5673,9979,56.849383705782145,43.150616294217855,9833,4304,4946,9250,53.47027027027027,46.52972972972973,6.319611661642721,-7.26226749035429
IOWA,IA,RINGGOLD,19159,2714,709,1974,2683,73.5743570629892,26.42564293701081,2707,753,1824,2577,70.77997671711292,29.220023282887077,3.9479814426113924,-9.5632379167638
IOWA,IA,SAC,19161,5535,1389,4069,5458,74.55111762550385,25.44888237449615,5212,1270,3703,4973,74.46209531469938,25.537904685300624,0.11955386217408215,-0.34858893829184945
IOWA,IA,SCOTT,19163,92599,46926,43958,90884,48.36714933321597,51.63285066678403,86220,40440,39149,79589,49.18895827312819,50.81104172687181,-1.6707183253384272,1.6173825845369416
IOWA,IA,SHELBY,19165,6795,1959,4711,6670,70.62968515742129,29.37031484257871,6370,1662,4362,6024,72.41035856573706,27.589641434262948,-2.4591418183617986,6.454137552162553
IOWA,IA,SIOUX,19167,19051,3019,15775,18794,83.9363626689369,16.063637331063106,18194,2300,14785,17085,86.53789874158619,13.462101258413814,-3.006239012594736,19.324888609223102
IOWA,IA,STORY,19169,51038,29175,20541,49716,41.31667873521603,58.68332126478397,50667,25709,19458,45167,43.08012486992716,56.91987513007284,-4.0934099890275295,3.098120174510788
IOWA,IA,TAMA,19171,9048,3577,5325,8902,59.818018422826334,40.181981577173666,8752,3196,4971,8167,60.8669033916983,39.1330966083017,-1.723243520574802,2.680301483347103
IOWA,IA,TAYLOR,19173,3249,746,2470,3216,76.80348258706468,23.196517412935325,3029,758,2111,2869,73.57964447542697,26.420355524573022,4.381426595115379,-12.202099660011278
IOWA,IA,UNION,19175,6185,2061,4024,6085,66.12982744453575,33.87017255546426,5832,1922,3525,5447,64.71452175509455,35.285478244905455,2.186998607201751,-4.011014615185326
IOWA,IA,VAN BUREN,19177,3791,875,2870,3745,76.6355140186916,23.364485981308412,3561,845,2527,3372,74.94068801897983,25.059311981020166,2.2615564982303438,-6.763258308908915
IOWA,IA,WAPELLO,19179,15633,5821,9536,15357,62.09546135312887,37.90453864687113,15149,5594,8715,14309,60.90572367041722,39.09427632958278,1.9534086634447556,-3.0432528605507714
IOWA,IA,WARREN,19181,31039,12574,17868,30442,58.69522370409303,41.30477629590697,27300,10411,14814,25225,58.72745292368682,41.27254707631318,-0.05487930769901839,0.07808875845292107
IOWA,IA,WASHINGTON,19183,11765,4561,6991,11552,60.51765927977839,39.48234072022161,10929,3943,6173,10116,61.02214313958086,38.97785686041914,-0.8267226187853249,1.2942832172867735
IOWA,IA,WAYNE,19185,3109,727,2344,3071,76.32692933897754,23.673070661022468,2940,719,2069,2788,74.21090387374461,25.78909612625538,2.8513673257947847,-8.205116824853075
IOWA,IA,WEBSTER,19187,17822,6613,10970,17583,62.389808337598815,37.610191662401185,17430,6305,10056,16361,61.46323574353646,38.53676425646354,1.507523290717394,-2.4043860763606983
IOWA,IA,WINNEBAGO,19189,5970,2135,3726,5861,63.57276915202184,36.42723084797816,5787,1931,3447,5378,64.09445890665675,35.90554109334325,-0.813938932528735,1.4529505439806023
IOWA,IA,WINNESHIEK,19191,12064,5617,6263,11880,52.71885521885522,47.28114478114478,11362,5254,5344,10598,50.424608416682396,49.575391583317604,4.549855465835995,-4.627793606666842
IOWA,IA,WOODBURY,19193,45362,18704,25926,44630,58.090970199417434,41.909029800582566,43718,16210,24727,40937,60.40256980237927,39.59743019762073,-3.8269888359464765,5.837751569799421
IOWA,IA,WORTH,19195,4418,1596,2742,4338,63.208852005532506,36.791147994467494,4257,1530,2453,3983,61.58674366055737,38.41325633944263,2.633859575228681,-4.222782704598682
IOWA,IA,WRIGHT,19197,6254,1996,4148,6144,67.51302083333333,32.486979166666664,6026,1896,3800,5696,66.71348314606742,33.28651685393258,1.1984649122806834,-2.401986638537268
KANSAS,KS,ALLEN,20001,5892,1570,4218,5788,72.87491361437456,27.125086385625433,5454,1433,3651,5084,71.81353265145555,28.186467348544454,1.4779679034456983,-3.7655693059876483
KANSAS,KS,ANDERSON,20003,3792,782,2929,3711,78.92751279978442,21.072487200215576,3350,672,2435,3107,78.37141937560348,21.628580624396523,0.7095615067475025,-2.571104566860416
KANSAS,KS,ATCHISON,20005,7440,2359,4906,7265,67.5292498279422,32.47075017205781,6575,1989,4049,6038,67.05862868499503,32.94137131500497,0.7018054979291088,-1.428662876377551
KANSAS,KS,BARBER,20007,2342,291,2014,2305,87.37527114967462,12.62472885032538,2252,286,1850,2136,86.61048689138576,13.389513108614231,0.883015770651352,-5.711815299667789
KANSAS,KS,BARTON,20009,11130,2340,8608,10948,78.62623310193642,21.373766898063572,10269,1839,7888,9727,81.09386244474145,18.90613755525856,-3.0429298450132425,13.052001423308512
KANSAS,KS,BOURBON,20011,6676,1541,5023,6564,76.52346130408287,23.476538695917124,6093,1336,4424,5760,76.80555555555556,23.194444444444443,-0.36728365472031843,1.2162147368881993
KANSAS,KS,BROWN,20013,4471,1104,3262,4366,74.71369674759505,25.28630325240495,4036,863,2906,3769,77.10267975590342,22.897320244096576,-3.098443550693142,10.433461133620225
KANSAS,KS,BUTLER,20015,32520,9181,22634,31815,71.14254282571115,28.857457174288857,27657,6573,19073,25646,74.37027216719956,25.629727832800437,-4.34008004466061,12.593693395985394
KANSAS,KS,CHASE,20017,1491,345,1123,1468,76.49863760217984,23.501362397820163,1369,316,969,1285,75.40856031128405,24.591439688715955,1.445561732508871,-4.432751008864222
KANSAS,KS,CHAUTAUQUA,20019,1639,212,1402,1614,86.86493184634449,13.135068153655514,1481,197,1236,1433,86.25261688764829,13.74738311235171,0.7099088477440674,-4.454047389906846
KANSAS,KS,CHEROKEE,20021,9128,2194,6766,8960,75.51339285714286,24.486607142857142,8620,2005,6182,8187,75.50995480640039,24.49004519359961,0.004553109257310339,-0.014038564303531231
KANSAS,KS,CHEYENNE,20023,1429,224,1183,1407,84.07960199004975,15.92039800995025,1407,181,1173,1354,86.63220088626292,13.367799113737075,-2.9464781802835738,19.095132074434474
KANSAS,KS,CLARK,20025,1067,143,904,1047,86.34192932187202,13.658070678127984,1005,120,825,945,87.3015873015873,12.698412698412698,-1.0992445949466023,7.557306590257884
KANSAS,KS,CLAY,20027,4182,894,3177,4071,78.0397936624908,21.960206337509213,3820,677,2891,3568,81.02578475336323,18.97421524663677,-3.6852356320417945,15.737099279516809
KANSAS,KS,CLOUD,20029,4263,920,3242,4162,77.8952426717924,22.104757328207594,3930,761,2919,3680,79.32065217391305,20.679347826086957,-1.797021914287078,6.892913229702957
KANSAS,KS,COFFEY,20031,4565,964,3489,4453,78.35167302941836,21.648326970581632,4068,727,3050,3777,80.75191951284089,19.248080487159122,-2.972370809143232,12.470056351976378
KANSAS,KS,COMANCHE,20033,916,126,762,888,85.8108108108108,14.18918918918919,867,102,715,817,87.51529987760098,12.48470012239902,-1.9476469476469527,13.652623211446734
KANSAS,KS,COWLEY,20035,14231,4273,9656,13929,69.3229951898916,30.677004810108407,12621,3551,8270,11821,69.96024025040182,30.039759749598172,-0.9108674558997998,2.12133873846565
KANSAS,KS,CRAWFORD,20037,16645,6179,10045,16224,61.91444773175542,38.08555226824458,14891,5199,8624,13823,62.388772335961804,37.611227664038196,-0.7602723798637245,1.2611250248018457
KANSAS,KS,DECATUR,20039,1498,218,1260,1478,85.25033829499323,14.749661705006766,1452,178,1210,1388,87.1757925072046,12.82420749279539,-2.2087028483879223,15.01421599185051
KANSAS,KS,DICKINSON,20041,9349,2060,7126,9186,77.57456999782278,22.425430002177226,8210,1609,6029,7638,78.93427598847866,21.06572401152134,-1.722579923143075,6.454589407476474
KANSAS,KS,DONIPHAN,20043,3709,686,2976,3662,81.26706717640633,18.732932823593664,3378,587,2606,3193,81.61603507673034,18.38396492326965,-0.42757271900789595,1.8982189194796772
KANSAS,KS,DOUGLAS,20045,59495,40785,17286,58071,29.767009350622512,70.23299064937748,50087,31195,14688,45883,32.01185624305298,67.98814375694701,-7.012548336423419,3.3018211240707585
KANSAS,KS,EDWARDS,20047,1431,271,1141,1412,80.80736543909349,19.192634560906516,1319,212,1037,1249,83.02642113690953,16.973578863090474,-2.672710285990587,13.073587578170919
KANSAS,KS,ELK,20049,1361,195,1140,1335,85.3932584269663,14.606741573033707,1259,160,1048,1208,86.75496688741723,13.245033112582782,-1.5696028818938168,10.280898876404487
KANSAS,KS,ELLIS,20051,13800,3737,9758,13495,72.30826231937755,27.691737680622452,11947,2742,8466,11208,75.53533190578159,24.464668094218414,-4.272265051313074,13.190735202194181
KANSAS,KS,ELLSWORTH,20053,2853,648,2148,2796,76.82403433476395,23.175965665236053,2679,521,1969,2490,79.07630522088354,20.923694779116467,-2.848224736636762,10.76421210448708
KANSAS,KS,FINNEY,20055,11800,4325,7236,11561,62.58974137185365,37.41025862814635,10159,3195,6350,9545,66.52697747511786,33.47302252488214,-5.918254898528641,11.76241583901625
KANSAS,KS,FORD,20057,8915,2947,5803,8750,66.32,33.68,7718,2149,5114,7263,70.41167561613658,29.588324383863416,-5.811075479077044,13.828683108422535
KANSAS,KS,FRANKLIN,20059,12477,3690,8479,12169,69.67704823732434,30.32295176267565,10965,2892,7185,10077,71.30098243524859,28.699017564751415,-2.2775761882369627,5.658501007082473
KANSAS,KS,GEARY,20061,9603,3983,5323,9306,57.19965613582635,42.80034386417365,7504,2722,4274,6996,61.092052601486564,38.907947398513436,-6.37136304954582,10.004116706009869
KANSAS,KS,GOVE,20063,1471,166,1291,1457,88.60672614962252,11.393273850377488,1343,149,1140,1289,88.44065166795966,11.559348332040342,0.1877807077749427,-1.436711455459183
KANSAS,KS,GRAHAM,20065,1337,228,1080,1308,82.56880733944953,17.431192660550458,1284,188,1025,1213,84.50123660346249,15.49876339653751,-2.2868650704855775,12.468280304509062
KANSAS,KS,GRANT,20067,2501,518,1936,2454,78.8916055419723,21.10839445802771,2389,441,1804,2245,80.35634743875278,19.643652561247215,-1.8228079591309232,7.456565891773725
KANSAS,KS,GRAY,20069,2288,341,1911,2252,84.85790408525754,15.142095914742452,2066,263,1698,1961,86.58847526772055,13.41152473227945,-1.9986160711483847,12.9036125049808
KANSAS,KS,GREELEY,20071,641,78,549,627,87.5598086124402,12.440191387559809,650,83,534,617,86.54781199351702,13.452188006482983,1.1692919735498242,-7.522914625007204
KANSAS,KS,GREENWOOD,20073,3077,569,2444,3013,81.11516760703617,18.884832392963823,2840,485,2160,2645,81.66351606805293,18.33648393194707,-0.6714729997172819,2.9904776894625007
KANSAS,KS,HAMILTON,20075,859,141,698,839,83.19427890345649,16.805721096543504,876,121,705,826,85.35108958837772,14.648910411622277,-2.5269867031842974,14.72335227888375
KANSAS,KS,HARPER,20077,2678,461,2168,2629,82.46481551920883,17.535184480791177,2578,393,1996,2389,83.54960234407702,16.45039765592298,-1.298374611528108,6.594289375598272
KANSAS,KS,HARVEY,20079,17309,6747,10182,16929,60.14531277689172,39.85468722310828,14916,5068,8668,13736,63.10425160163075,36.89574839836925,-4.688969046679203,8.019728432639162
KANSAS,KS,HASKELL,20081,1410,268,1122,1390,80.71942446043165,19.280575539568346,1354,245,1040,1285,80.93385214007782,19.06614785992218,-0.2649418926397362,1.124651299368673
KANSAS,KS,HODGEMAN,20083,1045,154,875,1029,85.03401360544218,14.965986394557824,1017,124,855,979,87.33401430030644,12.665985699693564,-2.633568047101875,18.158876453807338
KANSAS,KS,JACKSON,20085,6584,1881,4517,6398,70.60018755861206,29.399812441387933,5818,1512,3939,5451,72.26197028068245,27.738029719317556,-2.299664284845304,5.990990488098968
KANSAS,KS,JEFFERSON,20087,9782,3194,6334,9528,66.47774979009236,33.52225020990764,8337,2518,5213,7731,67.42982796533437,32.57017203466563,-1.4119540327634739,2.9231597985686975
KANSAS,KS,JEWELL,20089,1628,212,1387,1599,86.74171357098186,13.258286429018137,1494,180,1223,1403,87.17034925160371,12.829650748396293,-0.49172188054984467,3.3409769995135896
KANSAS,KS,JOHNSON,20091,347214,184259,155631,339890,45.78863750036776,54.21136249963224,290090,129852,137490,267342,51.428507305249454,48.571492694750546,-10.966427182898252,11.611481327793793
KANSAS,KS,KEARNY,20093,1455,267,1164,1431,81.34171907756813,18.658280922431867,1316,174,1075,1249,86.06885508406725,13.931144915932746,-5.49227243917898,33.93214294320346
KANSAS,KS,KINGMAN,20095,3949,752,3130,3882,80.62854198866563,19.371458011334365,3334,599,2530,3129,80.85650367529563,19.14349632470438,-0.2819336432668962,1.1908048705596475
KANSAS,KS,KIOWA,20097,1165,156,980,1136,86.26760563380282,13.732394366197184,1079,114,900,1014,88.75739644970415,11.242603550295858,-2.805164319248832,22.146034099332844
KANSAS,KS,LABETTE,20099,8563,2655,5735,8390,68.35518474374256,31.64481525625745,8107,2291,5335,7626,69.95803829006032,30.04196170993968,-2.2911642257205656,5.335382428729507
KANSAS,KS,LANE,20101,895,115,762,877,86.88711516533637,13.112884834663626,871,106,718,824,87.13592233009709,12.864077669902912,-0.2855391417309616,1.934123620404038
KANSAS,KS,LEAVENWORTH,20103,36490,13886,21610,35496,60.88009916610322,39.11990083389678,30301,10209,17638,27847,63.33895931339103,36.66104068660897,-3.8820659100535004,6.707011315655165
KANSAS,KS,LINCOLN,20105,1579,266,1283,1549,82.8276307295029,17.172369270497096,1464,215,1179,1394,84.5767575322812,15.423242467718795,-2.06809394662677,11.340850060804431
KANSAS,KS,LINN,20107,5046,896,4048,4944,81.87702265372168,18.12297734627832,4427,736,3484,4220,82.55924170616113,17.44075829383886,-0.8263388063416977,3.911636414802322
KANSAS,KS,LOGAN,20109,1458,186,1249,1435,87.0383275261324,12.961672473867596,1357,149,1132,1281,88.36846213895394,11.631537861046057,-1.505214168749458,11.435586839089872
KANSAS,KS,LYON,20111,13988,6055,7550,13605,55.49430356486586,44.50569643513414,12288,4649,6552,11201,58.49477725203107,41.50522274796893,-5.129472797609513,7.229147294028282
KANSAS,KS,MARION,20115,6111,1516,4465,5981,74.65306804882127,25.346931951178732,5624,1204,4003,5207,76.87728058382946,23.12271941617054,-2.8931987683706306,9.619165008129272
KANSAS,KS,MARSHALL,20117,5114,1259,3729,4988,74.75942261427426,25.240577385725743,4673,1072,3307,4379,75.51952500570907,24.480474994290933,-1.0064978446002515,3.104933182922598
KANSAS,KS,MCPHERSON,20113,14438,4134,9964,14098,70.67669172932331,29.32330827067669,12742,3226,8549,11775,72.60297239915074,27.397027600849256,-2.6531705330703037,7.03098415598824
KANSAS,KS,MEADE,20119,1825,263,1523,1786,85.27435610302352,14.725643896976484,1720,210,1415,1625,87.07692307692308,12.923076923076923,-2.0700857474111545,13.948434917079933
KANSAS,KS,MIAMI,20121,17937,5247,12308,17555,70.11107946454001,29.888920535459985,15022,3991,10003,13994,71.48063455766757,28.51936544233243,-1.9159806031417648,4.802193428520929
KANSAS,KS,MITCHELL,20123,3101,558,2504,3062,81.77661659046375,18.22338340953625,2942,477,2308,2785,82.87253141831239,17.127468581687612,-1.3224102233788892,6.398580284189648
KANSAS,KS,MONTGOMERY,20125,13426,3228,9931,13159,75.4692605821111,24.530739417888896,12004,2637,8679,11316,76.6967126193001,23.303287380699896,-1.6003971947033846,5.267291335923674
KANSAS,KS,MORRIS,20127,2899,729,2124,2853,74.44794952681389,25.55205047318612,2624,601,1820,2421,75.1755472945064,24.8244527054936,-0.9678649426283381,2.930972039240598
KANSAS,KS,MORTON,20129,1198,150,1034,1184,87.33108108108108,12.66891891891892,1192,147,995,1142,87.1278458844133,12.87215411558669,0.23326089909005976,-1.5788747931605118
KANSAS,KS,NEMAHA,20131,5684,927,4664,5591,83.41978179216598,16.58021820783402,5122,725,4124,4849,85.04846360074242,14.951536399257579,-1.9150043864663346,10.893073227292627
KANSAS,KS,NEOSHO,20133,6877,1796,4970,6766,73.45551285840969,26.544487141590306,6314,1501,4431,5932,74.69656102494943,25.30343897505057,-1.661452882851222,4.904662041248309
KANSAS,KS,NESS,20135,1513,149,1339,1488,89.98655913978494,10.013440860215054,1454,162,1228,1390,88.34532374100719,11.654676258992806,1.8577501663689544,-14.082204964821454
KANSAS,KS,NORTON,20137,2415,364,2007,2371,84.64782792070856,15.352172079291439,2234,281,1840,2121,86.75153229608675,13.24846770391325,-2.4249766196614897,15.878850463263849
KANSAS,KS,OSAGE,20139,8035,2136,5705,7841,72.75857671215407,27.241423287845937,7046,1753,4826,6579,73.3546131630947,26.645386836905306,-0.8125411957601303,2.2369217402957275
KANSAS,KS,OSBORNE,20141,1945,281,1629,1910,85.28795811518324,14.712041884816754,1788,233,1460,1693,86.23744831659775,13.762551683402245,-1.1010184321881944,6.899085454913156
KANSAS,KS,OTTAWA,20143,3191,506,2610,3116,83.7612323491656,16.238767650834404,2903,424,2283,2707,84.33690432212782,15.663095677872183,-0.6825860844541176,3.6753396953036033
KANSAS,KS,PAWNEE,20145,2739,643,2045,2688,76.07886904761905,23.921130952380953,2661,579,1904,2483,76.68143374949658,23.318566250503423,-0.7858026022909081,2.584055534994656
KANSAS,KS,PHILLIPS,20147,2781,318,2418,2736,88.37719298245614,11.62280701754386,2664,300,2233,2533,88.15633636004738,11.843663639952625,0.25052835851382405,-1.8647660818713496
KANSAS,KS,POTTAWATOMIE,20149,13083,3313,9452,12765,74.04622013317666,25.953779866823346,10693,2225,7612,9837,77.38131544169971,22.618684558300295,-4.309949100097377,14.744868561771352
KANSAS,KS,PRATT,20151,4137,933,3108,4041,76.9116555308092,23.088344469190794,3842,771,2838,3609,78.63674147963425,21.36325852036575,-2.1937403767828156,8.075013215706338
KANSAS,KS,RAWLINS,20153,1504,214,1261,1475,85.49152542372882,14.508474576271187,1472,163,1220,1383,88.21402747650036,11.78597252349964,-3.086246179494301,23.09951128210461
KANSAS,KS,RENO,20155,27941,8886,18443,27329,67.48508909949139,32.51491090050862,24210,6837,15513,22350,69.40939597315436,30.590604026845636,-2.7724011233396073,6.290516107410804
KANSAS,KS,REPUBLIC,20157,2657,424,2182,2606,83.72985418265542,16.270145817344588,2529,375,2024,2399,84.36848686952897,15.63151313047103,-0.7569564307359888,4.085546175492438
KANSAS,KS,RICE,20159,4319,965,3262,4227,77.17057014431039,22.829429855689614,3804,695,2837,3532,80.32276330690827,19.677236693091732,-3.9244082658779433,16.019491007619745
KANSAS,KS,RILEY,20161,25171,12765,11610,24375,47.63076923076923,52.36923076923077,21532,9341,10107,19448,51.969354175236525,48.030645824763475,-8.348352626892241,9.0329515041216
KANSAS,KS,ROOKS,20163,2699,339,2325,2664,87.27477477477477,12.725225225225225,2419,275,2031,2306,88.0745880312229,11.925411968777103,-0.9081089952581944,6.706797706797696
KANSAS,KS,RUSH,20165,1677,295,1350,1645,82.06686930091185,17.933130699088146,1503,233,1197,1430,83.7062937062937,16.293706293706293,-1.9585437758530166,10.061703432171875
KANSAS,KS,RUSSELL,20167,3467,600,2790,3390,82.30088495575221,17.699115044247787,3193,461,2574,3035,84.81054365733114,15.189456342668864,-2.959135260020218,16.522373447488125
KANSAS,KS,SALINE,20169,24531,8214,15722,23936,65.68348930481284,34.31651069518717,22064,6317,13828,20145,68.64234301315463,31.35765698684537,-4.310537167670336,9.435825226301331
KANSAS,KS,SCOTT,20171,2354,299,2014,2313,87.07306528318202,12.926934716817986,2202,236,1865,2101,88.76725368871966,11.232746311280343,-1.9085736407692178,15.082584067943161
KANSAS,KS,SEDGWICK,20173,223688,95870,122416,218286,56.08055486838368,43.91944513161632,188783,69627,104353,173980,59.97988274514312,40.02011725485688,-6.501059519118835,9.743419420607058
KANSAS,KS,SEWARD,20175,5294,1833,3372,5205,64.78386167146974,35.216138328530256,5038,1628,3159,4787,65.99122623772718,34.008773762272824,-1.829583469032725,3.550156129406834
KANSAS,KS,SHAWNEE,20177,85657,43015,40443,83458,48.459105178652734,51.540894821347266,75406,33926,35934,69860,51.43716003435442,48.56283996564558,-5.789695336431233,6.132373761107113
KANSAS,KS,SHERIDAN,20179,1445,147,1282,1429,89.71308607417775,10.286913925822253,1374,127,1197,1324,90.40785498489426,9.592145015105741,-0.7684829054207643,7.243102659753231
KANSAS,KS,SHERMAN,20181,2727,396,2269,2665,85.14071294559099,14.859287054409005,2612,347,2089,2436,85.75533661740559,14.244663382594418,-0.7167176948493781,4.314764451124886
KANSAS,KS,SMITH,20183,2129,336,1763,2099,83.99237732253454,16.00762267746546,2042,297,1661,1958,84.8314606741573,15.168539325842696,-0.9891181231049817,5.531734688475987
KANSAS,KS,STAFFORD,20185,2034,357,1645,2002,82.16783216783217,17.832167832167833,1896,304,1490,1794,83.0546265328874,16.9453734671126,-1.06772422208663,5.23325358851674
KANSAS,KS,STANTON,20187,776,148,614,762,80.5774278215223,19.42257217847769,637,115,492,607,81.05436573311367,18.945634266886326,-0.5884173014958471,2.517402715964856
KANSAS,KS,STEVENS,20189,2031,237,1760,1997,88.13219829744617,11.86780170255383,1891,220,1599,1819,87.90544255085211,12.094557449147883,0.257954160759577,-1.8748577411571987
KANSAS,KS,SUMNER,20191,10928,2591,8105,10696,75.77599102468213,24.224008975317876,9722,2076,6984,9060,77.08609271523179,22.91390728476821,-1.6995305435824615,5.717495817138718
KANSAS,KS,THOMAS,20193,3810,625,3130,3755,83.3555259653795,16.644474034620504,3576,473,2908,3381,86.0100561963916,13.9899438036084,-3.0863021702379423,18.974559642815912
KANSAS,KS,TREGO,20195,1630,242,1363,1605,84.9221183800623,15.077881619937695,1482,198,1227,1425,86.10526315789474,13.894736842105264,-1.3740678960156738,8.515057113187963
KANSAS,KS,WABAUNSEE,20197,3902,964,2845,3809,74.69152008401156,25.30847991598845,3380,776,2372,3148,75.34942820838627,24.65057179161372,-0.873142822736761,2.6689365664067655
KANSAS,KS,WALLACE,20199,825,44,770,814,94.5945945945946,5.405405405405405,798,46,721,767,94.0026075619296,5.9973924380704045,0.6297559695618071,-9.870740305522919
KANSAS,KS,WASHINGTON,20201,2883,475,2363,2838,83.26286116983792,16.737138830162085,2765,387,2194,2581,85.00581170089113,14.994188299108872,-2.050389845327405,11.624173955163663
KANSAS,KS,WICHITA,20203,968,149,808,957,84.43051201671891,15.569487983281087,956,140,769,909,84.59845984598459,15.401540154015402,-0.19852350689533171,1.0904612628750643
KANSAS,KS,WILSON,20205,3954,723,3153,3876,81.3467492260062,18.653250773993808,3591,594,2788,3382,82.43642814902425,17.563571850975755,-1.3218415056122867,6.20419885125767
KANSAS,KS,WOODSON,20207,1546,294,1228,1522,80.6833114323259,19.316688567674113,1443,273,1082,1355,79.85239852398524,20.14760147601476,1.0405609896502632,-4.124128171434349
KANSAS,KS,WYANDOTTE,20209,56785,36788,18934,55722,33.979397724417645,66.02060227558235,48781,30146,15806,45952,34.39676183844011,65.60323816155989,-1.2133819921270717,0.6361943796046043
KENTUCKY,KY,ADAIR,21001,8763,1392,7276,8668,83.94093216428242,16.05906783571758,8233,1323,6637,7960,83.37939698492463,16.62060301507538,0.6734699454102877,-3.378548773762713
KENTUCKY,KY,ALLEN,21003,9363,1642,7586,9228,82.20632856523623,17.793671434763763,8096,1349,6466,7815,82.73832373640435,17.26167626359565,-0.6429851937332032,3.081943856692959
KENTUCKY,KY,ANDERSON,21005,13240,3347,9657,13004,74.26176561058136,25.73823438941864,11422,2634,8242,10876,75.7815373299007,24.218462670099303,-2.005464355656039,6.275260903309454
KENTUCKY,KY,BALLARD,21007,4225,825,3356,4181,80.26787849796699,19.732121502033007,4101,816,3161,3977,79.48202162433995,20.517978375660046,0.9887228049398011,-3.8300891990376673
KENTUCKY,KY,BARREN,21009,20055,5127,14654,19781,74.08118901976644,25.91881098023356,18488,4275,13483,17758,75.92634305665052,24.073656943349476,-2.4301895265881113,7.6646188039736884
KENTUCKY,KY,BATH,21011,5627,1573,3986,5559,71.70354380284223,28.296456197157763,4587,1361,3082,4443,69.36754445194688,30.632455548053116,3.3675681752199926,-7.625896484958162
KENTUCKY,KY,BELL,21013,10044,1789,8140,9929,81.98207271628563,18.01792728371437,9718,1720,7764,9484,81.86419232391395,18.13580767608604,0.14399505940918544,-0.6499870007284247
KENTUCKY,KY,BOONE,21015,66953,20897,44811,65708,68.19717538199306,31.80282461800694,57618,15026,39082,54108,72.22961484438531,27.770385155614697,-5.582806264549401,14.52064650812721
KENTUCKY,KY,BOURBON,21017,9643,3296,6190,9486,65.25405861269239,34.74594138730761,8803,2791,5569,8360,66.61483253588517,33.38516746411483,-2.0427491466855185,4.075983517696757
KENTUCKY,KY,BOYD,21019,21741,7083,14295,21378,66.86780802694359,33.132191973056415,20454,6021,13591,19612,69.29940852539262,30.700591474607382,-3.5088329759092263,7.920370200229598
KENTUCKY,KY,BOYLE,21021,14467,5298,8872,14170,62.61115031757234,37.38884968242766,12946,4281,8040,12321,65.25444363282202,34.74555636717799,-4.05074837527255,7.607572281520958
KENTUCKY,KY,BRACKEN,21023,4244,800,3398,4198,80.94330633635064,19.056693663649355,3527,705,2711,3416,79.36182669789227,20.638173302107727,1.9927460143761788,-7.662885737551484
KENTUCKY,KY,BREATHITT,21025,5661,1301,4265,5566,76.62594322673374,23.37405677326626,5738,1537,3991,5528,72.19609261939219,27.803907380607814,6.135859222596873,-15.932475053600593
KENTUCKY,KY,BRECKINRIDGE,21027,10197,2350,7701,10051,76.61924186648095,23.380758133519052,8774,1960,6484,8444,76.78825201326386,23.211747986736142,-0.22009896351555813,0.7281233058341163
KENTUCKY,KY,BULLITT,21029,41964,10551,30708,41259,74.42739765869266,25.572602341307352,36069,8255,26210,34465,76.04816480487452,23.95183519512549,-2.1312376838289904,6.766776461921009
KENTUCKY,KY,BUTLER,21031,6122,1079,4960,6039,82.13280344427885,17.867196555721147,5576,947,4428,5375,82.38139534883722,17.61860465116279,-0.30175733672114236,1.4109624994732561
KENTUCKY,KY,CALDWELL,21033,6428,1433,4906,6339,77.39391071146869,22.606089288531315,5975,1260,4507,5767,78.15155193341425,21.848448066585746,-0.9694512817750245,3.4677118467937307
KENTUCKY,KY,CALLOWAY,21035,17443,5794,11351,17145,66.20589093030038,33.79410906969962,16049,4749,10367,15116,68.58295845461762,31.417041545382375,-3.465974023109808,7.566172393678561
KENTUCKY,KY,CAMPBELL,21037,48833,19373,28482,47855,59.51729181903667,40.48270818096333,42510,14658,25050,39708,63.085524327591415,36.914475672408585,-5.656182692602463,9.666214793948136
KENTUCKY,KY,CARLISLE,21039,2638,463,2159,2622,82.34172387490466,17.658276125095348,2601,432,2094,2526,82.8978622327791,17.102137767220903,-0.6708717726794933,3.2518645647936273
KENTUCKY,KY,CARROLL,21041,4135,1116,2954,4070,72.57985257985258,27.42014742014742,3855,1106,2588,3694,70.05955603681646,29.94044396318354,3.5973629945809327,-8.417699303775251
KENTUCKY,KY,CARTER,21043,11585,2642,8775,11417,76.85906980818078,23.140930191819216,10278,2276,7587,9863,76.92385683869006,23.076143161309947,-0.08422228574047619,0.28075328730796656
KENTUCKY,KY,CASEY,21045,7171,918,6179,7097,87.06495702409468,12.935042975905311,6439,767,5482,6249,87.72603616578652,12.273963834213474,-0.7535723379117676,5.386028104866103
KENTUCKY,KY,CHRISTIAN,21047,23863,8296,15080,23376,64.51060917180014,35.489390828199866,22083,7188,14108,21296,66.24718256949662,33.752817430503384,-2.621354343446569,5.144973160454125
KENTUCKY,KY,CLARK,21049,18128,6004,11811,17815,66.29806342969408,33.701936570305925,16205,4706,10710,15416,69.47327451997924,30.526725480020758,-4.570406551618678,10.401413975315798
KENTUCKY,KY,CLAY,21051,7590,831,6677,7508,88.93180607352157,11.068193926478424,6767,752,5861,6613,88.62845909572054,11.371540904279449,0.3422681392591942,-2.6675978247316268
KENTUCKY,KY,CLINTON,21053,4932,603,4280,4883,87.6510342002867,12.348965799713291,4462,547,3809,4356,87.44260789715335,12.557392102846649,0.23835783051953108,-1.6597897192850208
KENTUCKY,KY,CRITTENDEN,21055,4242,731,3451,4182,82.52032520325203,17.479674796747968,4037,617,3290,3907,84.20783209623752,15.792167903762477,-2.003978550423813,10.685720309391101
KENTUCKY,KY,CUMBERLAND,21057,3309,508,2769,3277,84.49801647848642,15.50198352151358,3066,459,2502,2961,84.4984802431611,15.501519756838906,-5.488438056477918e-4,0.002991736822899327
KENTUCKY,KY,DAVIESS,21059,49240,17283,31023,48306,64.22183579679543,35.77816420320457,45807,14163,28907,43070,67.11632226607848,32.88367773392152,-4.3126416519189466,8.802198138249008
KENTUCKY,KY,EDMONSON,21061,6131,1227,4828,6055,79.73575557390586,20.264244426094137,5244,979,4135,5114,80.8564724286273,19.1435275713727,-1.3860570725623744,5.854286001067854
KENTUCKY,KY,ELLIOTT,21063,2995,712,2246,2958,75.92968221771467,24.07031778228533,2855,740,2000,2740,72.99270072992701,27.00729927007299,4.023664638269087,-10.87476929261918
KENTUCKY,KY,ESTILL,21065,6538,1355,5100,6455,79.00852052672347,20.99147947327653,5545,1108,4236,5344,79.26646706586827,20.733532934131738,-0.325416974785131,1.244103163528676
KENTUCKY,KY,FAYETTE,21067,152664,90566,58845,149411,39.384650393879966,60.615349606120034,136315,69778,56894,126672,44.91442465580397,55.08557534419603,-12.31180028309553,10.038515940646576
KENTUCKY,KY,FLEMING,21069,7066,1474,5534,7008,78.96689497716895,21.03310502283105,6260,1348,4722,6070,77.79242174629324,22.207578253706753,1.5097527554882584,-5.2886146227118065
KENTUCKY,KY,FLOYD,21071,16351,3884,12250,16134,75.92661460270237,24.07338539729763,16540,4015,11993,16008,74.91879060469765,25.08120939530235,1.345221926128537,-4.018243227910212
KENTUCKY,KY,FRANKLIN,21073,26059,12650,12900,25550,50.489236790606654,49.510763209393346,23865,10717,11819,22536,52.444976925807595,47.555023074192405,-3.7291276492840697,4.112583716234797
KENTUCKY,KY,FULTON,21075,2421,791,1605,2396,66.98664440734558,33.01335559265443,2382,774,1549,2323,66.68101592767972,33.318984072320276,0.45834406601923394,-0.9172803078343228
KENTUCKY,KY,GALLATIN,21077,3849,822,2955,3777,78.23669579030977,21.76330420969023,3338,749,2443,3192,76.53508771929825,23.464912280701753,2.2233045283130526,-7.251712900759388
KENTUCKY,KY,GARRARD,21079,8703,1830,6754,8584,78.68126747437093,21.318732525629077,7623,1453,5904,7357,80.25010194372706,19.749898056272936,-1.9549314347989677,7.943506669685574
KENTUCKY,KY,GRANT,21081,11106,2205,8725,10930,79.82616651418115,20.173833485818847,9559,1910,7268,9178,79.18936587491828,20.810634125081716,0.8041491837031733,-3.059977103222311
KENTUCKY,KY,GRAVES,21083,17018,3559,13206,16765,78.77124962719952,21.228750372800476,16606,3308,12671,15979,79.2978283997747,20.702171600225295,-0.6640519459378713,2.543591960997227
KENTUCKY,KY,GRAYSON,21085,11983,2400,9453,11853,79.75196152872691,20.248038471273095,10576,1959,8219,10178,80.75260365494204,19.247396345057968,-1.2391453413575282,5.198844084031418
KENTUCKY,KY,GREEN,21087,5812,920,4838,5758,84.02222994095172,15.97777005904828,5333,832,4372,5204,84.01229823212913,15.987701767870869,0.011821732093486581,-0.06212092874128272
KENTUCKY,KY,GREENUP,21089,18176,4873,13064,17937,72.83269220047946,27.167307799520543,16277,4146,11546,15692,73.57889370379812,26.421106296201888,-1.0141515667829948,2.8242629016103082
KENTUCKY,KY,HANCOCK,21091,4587,1351,3145,4496,69.95106761565836,30.048932384341636,4295,1244,2788,4032,69.14682539682539,30.853174603174605,1.1630934814686356,-2.6066757446419064
KENTUCKY,KY,HARDIN,21093,48941,18101,29832,47933,62.236872300920034,37.763127699079966,43156,13944,26971,40915,65.91958939264329,34.08041060735672,-5.586680872339067,10.805964558796365
KENTUCKY,KY,HARLAN,21095,10971,1494,9367,10861,86.24436055611822,13.75563944388178,10757,1372,9129,10501,86.93457765927054,13.065422340729455,-0.7939500274074418,5.282776822305069
KENTUCKY,KY,HARRISON,21097,8853,2400,6334,8734,72.52118158919167,27.478818410808334,7781,2031,5435,7466,72.79667827484597,27.20332172515403,-0.37844678106624396,1.0127317848818373
KENTUCKY,KY,HART,21099,8369,1908,6345,8253,76.88113413304254,23.11886586695747,7264,1730,5320,7050,75.46099290780141,24.53900709219858,1.8819540672838198,-5.7872807155779356
KENTUCKY,KY,HENDERSON,21101,20688,7639,12730,20369,62.496931611762975,37.503068388237025,19710,6707,12159,18866,64.44927382593025,35.55072617406976,-3.0292695297705174,5.49170839607569
KENTUCKY,KY,HENRY,21103,8107,2142,5843,7985,73.17470256731372,26.825297432686288,7149,1828,4944,6772,73.00649734199645,26.993502658003543,0.23039761040626328,-0.6231322679696172
KENTUCKY,KY,HICKMAN,21105,2199,458,1714,2172,78.9134438305709,21.086556169429098,2157,449,1657,2106,78.67996201329535,21.320037986704655,0.2967487671589053,-1.0951285237913666
KENTUCKY,KY,HOPKINS,21107,21509,5439,15757,21196,74.33949801849406,25.660501981505945,20345,4310,15277,19587,77.99560933272068,22.004390667279317,-4.687586064787386,16.61537176606891
KENTUCKY,KY,JACKSON,21109,6113,605,5453,6058,90.01320567844174,9.98679432155827,5501,482,4889,5371,91.0258797244461,8.9741202755539,-1.1125122317630298,11.28438236740552
KENTUCKY,KY,JEFFERSON,21111,386093,228288,150619,378907,39.75091513220922,60.24908486779078,353099,190836,143768,334604,42.966611277808994,57.033388722191006,-7.484174455388304,5.638269472752877
KENTUCKY,KY,JESSAMINE,21113,26251,8567,17096,25663,66.61730896621596,33.38269103378405,23326,6144,15474,21618,71.57923952262004,28.42076047737996,-6.9320805718200535,17.458824018285092
KENTUCKY,KY,JOHNSON,21115,10192,1608,8450,10058,84.01272618810897,15.987273811891033,9572,1250,8043,9293,86.5490153879264,13.450984612073604,-2.9304656886613656,18.8557884271227
KENTUCKY,KY,KENTON,21117,82108,32265,48123,80388,59.86341244961935,40.13658755038065,71998,24214,42958,67172,63.95224200559757,36.04775799440243,-6.393567180366155,11.342812378548327
KENTUCKY,KY,KNOTT,21119,6251,1412,4779,6191,77.19269907930867,22.807300920691326,5763,1245,4357,5602,77.77579435915744,22.224205640842555,-0.7497130497390092,2.623694584508285
KENTUCKY,KY,KNOX,21121,13273,2114,11012,13126,83.89456041444461,16.105439585555388,12012,1761,9885,11646,84.87892838742916,15.121071612570839,-1.1597318577013627,6.509908809414
KENTUCKY,KY,LARUE,21123,7301,1504,5685,7189,79.07914869940187,20.920851300598137,6367,1278,4799,6077,78.96988645713346,21.030113542866545,0.13835937617527883,-0.5195513664046247
KENTUCKY,KY,LAUREL,21125,28097,4474,23234,27708,83.85303883354987,16.146961166450122,24833,3440,20592,24032,85.68575233022636,14.314247669773636,-2.138877756028046,12.80342173027016
KENTUCKY,KY,LAWRENCE,21127,6955,1238,5633,6871,81.98224421481589,18.017755785184107,6042,1045,4816,5861,82.17027810953762,17.829721890462377,-0.22883443873837894,1.0546092411139352
KENTUCKY,KY,LEE,21129,2659,459,2159,2618,82.46753246753246,17.532467532467532,2667,444,2151,2595,82.89017341040463,17.109826589595375,-0.5098806354036589,2.4701649701649675
KENTUCKY,KY,LESLIE,21131,4811,446,4321,4767,90.64401090832808,9.35598909167191,4492,400,4015,4415,90.93997734994338,9.060022650056625,-0.3254525130090946,3.2667295993286993
KENTUCKY,KY,LETCHER,21133,9135,1799,7226,9025,80.06648199445983,19.933518005540165,9134,1542,7293,8835,82.54668930390493,17.453310696095077,-3.0046114875836305,14.210526315789473
KENTUCKY,KY,LEWIS,21135,5883,823,4986,5809,85.83232914443106,14.167670855568945,5298,785,4363,5148,84.75135975135976,15.248640248640248,1.2754596460075707,-7.088955968829391
KENTUCKY,KY,LINCOLN,21137,10913,2254,8489,10743,79.01889602531881,20.981103974681186,9561,1865,7338,9203,79.73486906443551,20.26513093556449,-0.8979422020974459,3.5330294257324146
KENTUCKY,KY,LIVINGSTON,21139,5003,939,4010,4949,81.02646999393816,18.973530006061832,4645,887,3570,4457,80.09872111285618,19.901278887143818,1.1582567963536183,-4.6617550879170295
KENTUCKY,KY,LOGAN,21141,12346,3094,9067,12161,74.55801332127292,25.44198667872708,10899,2755,7778,10533,73.84410899079084,26.155891009209153,0.966772218175338,-2.729420803255056
KENTUCKY,KY,LYON,21143,4228,1092,3100,4192,73.95038167938931,26.049618320610687,3962,1045,2789,3834,72.74387063119457,27.256129368805425,1.6585741695154699,-4.42656780744366
KENTUCKY,KY,MADISON,21151,43903,15580,27353,42933,63.71089837654019,36.28910162345981,37371,11793,23431,35224,66.51998637292755,33.48001362707245,-4.222923289008074,8.390343049669147
KENTUCKY,KY,MAGOFFIN,21153,5446,1213,4174,5387,77.48282903285688,22.517170967143123,5116,1172,3824,4996,76.5412329863891,23.45876701361089,1.2301814456467053,-4.013834341427436
KENTUCKY,KY,MARION,21155,8928,2722,6113,8835,69.19071873231466,30.809281267685343,8111,2679,5122,7801,65.65824894244328,34.34175105755672,5.380085285198488,-10.28622502082367
KENTUCKY,KY,MARSHALL,21157,17601,4071,13297,17368,76.56034085674804,23.43965914325196,16698,3672,12322,15994,77.04139052144554,22.958609478554457,-0.6244041825330116,2.0952909414955867
KENTUCKY,KY,MARTIN,21159,3930,403,3496,3899,89.66401641446525,10.335983585534752,3953,363,3503,3866,90.61045007759958,9.389549922400414,-1.044508290515933,10.079648875144208
KENTUCKY,KY,MASON,21161,7958,2362,5477,7839,69.86860568950121,30.131394310498788,7219,1970,4944,6914,71.50708706971362,28.492912930286376,-2.2913552311465635,5.750487443039898
KENTUCKY,KY,MCCRACKEN,21145,33521,11190,21820,33010,66.10118146016359,33.89881853983641,31307,9134,20774,29908,69.45967634077839,30.540323659221613,-4.8351720847899955,10.996919738277589
KENTUCKY,KY,MCCREARY,21147,6435,725,5664,6389,88.65237126310846,11.347628736891533,5776,664,5012,5676,88.30162085976039,11.698379140239606,0.39721853340057844,-2.9982820623549067
KENTUCKY,KY,MCLEAN,21149,4782,1074,3633,4707,77.18291905672403,22.817080943275972,4566,988,3381,4369,77.3861295490959,22.6138704509041,-0.2625929136860994,0.8986099607011244
KENTUCKY,KY,MEADE,21163,14110,3632,10184,13816,73.71163867979155,26.288361320208455,12231,3026,8660,11686,74.10576758514462,25.89423241485538,-0.5318464651219434,1.5220721705076157
KENTUCKY,KY,MENIFEE,21165,3102,750,2311,3061,75.49820320156812,24.501796798431887,2779,700,2010,2710,74.16974169741698,25.830258302583026,1.7911097891788907,-5.1430438232137
KENTUCKY,KY,MERCER,21167,11735,3033,8506,11539,73.7152266227576,26.284773377242395,10585,2395,7740,10135,76.36901825357671,23.630981746423284,-3.474958420975671,11.230137026451636
KENTUCKY,KY,METCALFE,21169,5012,975,3959,4934,80.23915687069315,19.76084312930685,4620,976,3491,4467,78.15088426236848,21.84911573763152,2.672103621136146,-9.557698505518763
KENTUCKY,KY,MONROE,21171,5330,657,4628,5285,87.5685903500473,12.431409649952696,4991,601,4278,4879,87.68190202910432,12.318097970895675,-0.12923040722748746,0.9198796707474255
KENTUCKY,KY,MONTGOMERY,21173,12837,3630,8993,12623,71.24296918323695,28.757030816763052,11452,3158,7856,11014,71.32740148901398,28.672598510986017,-0.11837288898016718,0.2944703660000769
KENTUCKY,KY,MORGAN,21175,5535,1172,4297,5469,78.57012250868532,21.429877491314684,4775,1006,3628,4634,78.29089339663358,21.709106603366422,0.3566559275765657,-1.286230323307902
KENTUCKY,KY,MUHLENBERG,21177,14229,3544,10496,14040,74.75783475783476,25.242165242165242,13060,3272,9393,12665,74.16502171338334,25.83497828661666,0.7993162150513378,-2.294614061117728
KENTUCKY,KY,NELSON,21179,23245,7188,15703,22891,68.59901271241972,31.40098728758027,20802,6434,13431,19865,67.61137679335515,32.38862320664485,1.4607540415618958,-3.0493297376776307
KENTUCKY,KY,NICHOLAS,21181,3396,955,2408,3363,71.60273565269105,28.39726434730895,2841,787,1957,2744,71.3192419825073,28.68075801749271,0.3974995559449246,-0.9884455285695481
KENTUCKY,KY,OHIO,21183,11127,2404,8582,10986,78.11760422355725,21.882395776442745,10398,2080,7942,10022,79.24565954899222,20.75434045100778,-1.4234916232069073,5.4352742651486485
KENTUCKY,KY,OLDHAM,21185,37936,14504,22651,37155,60.96353115327681,39.03646884672319,32853,10268,20469,30737,66.59400722256564,33.40599277743436,-8.454929060615102,16.854688638657045
KENTUCKY,KY,OWEN,21187,5456,1098,4292,5390,79.62894248608535,20.371057513914657,5001,1062,3745,4807,77.90721863948409,22.092781360515914,2.2099670308711072,-7.793151158768596
KENTUCKY,KY,OWSLEY,21189,1895,216,1670,1886,88.54718981972428,11.452810180275716,1759,256,1474,1730,85.20231213872832,14.797687861271676,3.9258062334620147,-22.604056203605516
KENTUCKY,KY,PENDLETON,21191,6925,1322,5515,6837,80.66403393301155,19.335966066988444,6007,1164,4604,5768,79.81969486823856,20.180305131761443,1.0578079334514934,-4.1839757092875125
KENTUCKY,KY,PERRY,21193,10606,2350,8118,10468,77.55063049293084,22.449369507069164,10572,2136,8158,10294,79.25004857198368,20.74995142801632,-2.144374810709737,8.189985817308031
KENTUCKY,KY,PIKE,21195,25368,4862,20279,25141,80.66107155642177,19.33892844357822,24665,4280,19747,24027,82.18670662171724,17.813293378282765,-1.8563039304124174,8.564587316320992
KENTUCKY,KY,POWELL,21197,5505,1367,4041,5408,74.72263313609467,25.277366863905325,4957,1272,3513,4785,73.41692789968653,26.58307210031348,1.7784798053552375,-4.9117921039410595
KENTUCKY,KY,PULASKI,21199,31537,5664,25441,31105,81.7907088892461,18.2092911107539,28041,4208,22902,27110,84.47805237919587,15.52194762080413,-3.181114401036511,17.31318488891118
KENTUCKY,KY,ROBERTSON,21201,1146,253,884,1137,77.74846086191732,22.251539138082673,1013,222,759,981,77.37003058103976,22.629969418960243,0.48911739860459935,-1.6722527276616939
KENTUCKY,KY,ROCKCASTLE,21203,7783,1134,6577,7711,85.293736220983,14.70626377901699,6691,915,5609,6524,85.97486204782342,14.025137952176578,-0.7922383480668316,4.856464365362667
KENTUCKY,KY,ROWAN,21205,10058,3880,5994,9874,60.70488150698805,39.29511849301195,8848,3295,5174,8469,61.093399456842604,38.906600543157396,-0.6359409581210285,0.9985913557870152
KENTUCKY,KY,RUSSELL,21207,8939,1329,7506,8835,84.95755517826825,15.042444821731749,8174,1093,6863,7956,86.26194067370538,13.73805932629462,-1.512121667156907,9.494685271452695
KENTUCKY,KY,SCOTT,21209,28950,10564,17764,28328,62.708274498729175,37.291725501270825,24200,7715,15052,22767,66.11323406685115,33.88676593314886,-5.150193627918743,10.048051132525316
KENTUCKY,KY,SHELBY,21211,23542,8076,15054,23130,65.08430609597924,34.91569390402075,20580,6276,13196,19472,67.76910435497125,32.23089564502876,-3.9616847301524927,8.329890328089862
KENTUCKY,KY,SIMPSON,21213,8732,2681,5888,8569,68.7128019605555,31.287198039444508,7531,2144,5077,7221,70.30882149286802,29.691178507131976,-2.270013205205579,5.375399740125375
KENTUCKY,KY,SPENCER,21215,11429,2530,8737,11267,77.545043046063725,22.454956953936275,9515,1921,7196,9117,78.92947241417133,21.07052758582867,-1.7540081363308868,6.570454216052579
KENTUCKY,KY,TAYLOR,21217,12510,2961,9376,12337,75.9990273162033,24.00097268379671,11306,2553,8320,10873,76.51981973696311,23.480180263036882,-0.6805980758319063,2.2180086137570054
KENTUCKY,KY,TODD,21219,5351,1202,4060,5262,77.15697453439756,22.843025465602434,4779,1042,3612,4654,77.61065749892566,22.389342501074346,-0.584562712323855,2.026334469207036
KENTUCKY,KY,TRIGG,21221,7375,1791,5487,7278,75.39159109645507,24.60840890354493,6751,1587,4931,6518,75.65204050322184,24.347959496778152,-0.3442728114593008,1.0696970594239907
KENTUCKY,KY,TRIMBLE,21223,4319,1012,3227,4239,76.12644491625383,23.873555083746165,3798,879,2771,3650,75.91780821917808,24.08219178082192,0.27481917875369355,-0.8663526101552965
KENTUCKY,KY,UNION,21225,6576,1529,4965,6494,76.45518940560517,23.544810594394825,6211,1331,4701,6032,77.934350132626,22.065649867374006,-1.8979573506465952,6.703454173846413
KENTUCKY,KY,WARREN,21227,55351,22477,31790,54267,58.58072124864098,41.41927875135902,48454,16966,28673,45639,62.82565349810469,37.17434650189531,-6.756686183283033,11.418982844116154
KENTUCKY,KY,WASHINGTON,21229,6223,1644,4482,6126,73.16356513222331,26.83643486777669,5636,1420,4013,5433,73.86342720412296,26.136572795877047,-0.9475082573213944,2.677711715937159
KENTUCKY,KY,WAYNE,21231,9240,1700,7430,9130,81.38006571741512,18.619934282584886,7992,1431,6371,7802,81.65854908997693,18.34145091002307,-0.3410339464334111,1.518327933422281
KENTUCKY,KY,WEBSTER,21233,5991,1412,4506,5918,76.14058803649881,23.859411963501184,5805,1240,4397,5637,78.00248359056235,21.997516409437644,-2.386969578861986,8.464117127625958
KENTUCKY,KY,WHITLEY,21235,15347,2552,12567,15119,83.12057675772208,16.879423242277927,13774,2067,11312,13379,84.55041482920996,15.449585170790044,-1.6911071038221648,9.254863840559446
KENTUCKY,KY,WOLFE,21237,2979,839,2097,2936,71.42370572207085,28.576294277929154,2635,753,1804,2557,70.55142745404771,29.44857254595229,1.2363722457511939,-2.9620392182405753
KENTUCKY,KY,WOODFORD,21239,15211,6530,8362,14892,56.15095353209777,43.84904646790223,13563,4958,7697,12655,60.821809561438165,39.178190438561835,-7.679574256372956,11.92208209989969
LOUISIANA,LA,ACADIA,22001,28425,5443,22596,28039,80.58775277292342,19.412247227076573,27389,5638,21162,26800,78.96268656716418,21.03731343283582,2.058017877060192,-7.724685050434166
LOUISIANA,LA,ALLEN,22003,9810,2108,7574,9682,78.22763891757901,21.772361082420986,9245,2106,6867,8973,76.5295887662989,23.470411233701103,2.218815204228397,-7.234854704385796
LOUISIANA,LA,ASCENSION,22005,62325,20399,40687,61086,66.60609632321645,33.39390367678355,54678,16476,36143,52619,68.6881164598339,31.3118835401661,-3.03112131169726,6.649297011936972
LOUISIANA,LA,ASSUMPTION,22007,11235,3833,7271,11104,65.48090778097983,34.51909221902017,10904,3931,6714,10645,63.07186472522311,36.92813527477689,3.8195209008832887,-6.5235978958357315
LOUISIANA,LA,AVOYELLES,22009,17292,4979,12028,17007,70.7238196036926,29.276180396307403,16586,5035,11165,16200,68.91975308641975,31.080246913580247,2.61763345990329,-5.804543709994059
LOUISIANA,LA,BEAUREGARD,22011,16357,2542,13575,16117,84.22783396413725,15.772166035862753,15078,2393,12238,14631,83.64431686145855,16.355683138541455,0.6976171538888742,-3.5676718467580804
LOUISIANA,LA,BIENVILLE,22013,7050,3067,3891,6958,55.92124173613107,44.07875826386893,7005,3129,3756,6885,54.553376906318086,45.446623093681914,2.5073880067258747,-3.0098272142097815
LOUISIANA,LA,BOSSIER,22015,54655,15662,38074,53736,70.85380378145005,29.14619621854995,49848,12641,35474,48115,73.727527797984,26.272472202016004,-3.8977626164382495,10.938156083817008
LOUISIANA,LA,CADDO,22017,104912,55110,48021,103131,46.563109055473134,53.436890944526866,105804,53483,49006,102489,47.81586316580316,52.18413683419684,-2.6199550261929883,2.400641624695954
LOUISIANA,LA,CALCASIEU,22019,82663,25982,55066,81048,67.94245385450597,32.05754614549403,83785,26296,54191,80487,67.32888541006622,32.67111458993378,0.9113004629481392,-1.8780150360367398
LOUISIANA,LA,CALDWELL,22021,4762,745,3976,4721,84.21944503283203,15.780554967167973,4692,788,3822,4610,82.90672451193059,17.093275488069413,1.5833703823536327,-7.679748225070604
LOUISIANA,LA,CAMERON,22023,4039,324,3671,3995,91.88986232790988,8.110137672090113,3692,323,3256,3579,90.97513271863649,9.024867281363509,1.0054721350090556,-10.135657187583536
LOUISIANA,LA,CATAHOULA,22025,4858,1269,3541,4810,73.61746361746361,26.382536382536383,4856,1322,3479,4801,72.4640699854197,27.535930014580295,1.5916765816162304,-4.188685951167037
LOUISIANA,LA,CLAIBORNE,22027,6580,2731,3770,6501,57.99107829564682,42.00892170435318,6421,2717,3585,6302,56.886702634084415,43.113297365915585,1.9413599495582412,-2.5615662197888467
LOUISIANA,LA,CONCORDIA,22029,8828,3177,5550,8727,63.59573736679271,36.40426263320729,8872,3272,5477,8749,62.60144016459024,37.39855983540976,1.5882976487254785,-2.658651045864746
LOUISIANA,LA,DE SOTO,22031,14736,5457,9112,14569,62.54375729288215,37.45624270711785,13500,5165,8068,13233,60.9687901458475,39.0312098541525,2.58323503429716,-4.035148161996027
LOUISIANA,LA,EAST BATON ROUGE,22033,208182,115577,88420,203997,43.343774663352896,56.656225336647104,196491,102828,84660,187488,45.15488991295443,54.84511008704557,-4.010895061626418,3.3022365106516904
LOUISIANA,LA,EAST CARROLL,22035,3036,1900,1080,2980,36.241610738255034,63.758389261744966,2939,1838,1059,2897,36.55505695547118,63.44494304452882,-0.8574633534232046,0.4940444457427473
LOUISIANA,LA,EAST FELICIANA,22037,10509,4280,6064,10344,58.62335653518948,41.37664346481052,10042,4235,5569,9804,56.80334557323541,43.19665442676459,3.2040559294303605,-4.213314633057308
LOUISIANA,LA,EVANGELINE,22039,15412,4158,11053,15211,72.66451909802117,27.33548090197883,14882,4208,10360,14568,71.11477210323997,28.88522789676002,2.179219519302378,-5.365188740487737
LOUISIANA,LA,FRANKLIN,22041,9720,2658,6970,9628,72.39302035729123,27.606979642708765,9162,2506,6514,9020,72.21729490022173,27.78270509977827,0.2433287723007327,-0.6324994504257497
LOUISIANA,LA,GRANT,22043,9392,1157,8117,9274,87.52426137588958,12.475738624110416,8821,1181,7408,8589,86.24985446501339,13.750145534986611,1.4775757232067477,-9.268315798065741
LOUISIANA,LA,IBERIA,22045,32713,11027,21251,32278,65.83741247908793,34.162587520912076,32454,10698,20903,31601,66.14664092908453,33.85335907091548,-0.46748927179555144,0.9134350577998163
LOUISIANA,LA,IBERVILLE,22047,16719,8514,7893,16407,48.10751508502469,51.89248491497531,16043,8324,7320,15644,46.79110201994375,53.20889798005625,2.8133833319844426,-2.4740468512885805
LOUISIANA,LA,JACKSON,22049,7632,2143,5394,7537,71.56693644686214,28.433063553137853,7464,2139,5169,7308,70.73070607553366,29.26929392446634,1.1822734675311475,-2.8570226992372993
LOUISIANA,LA,JEFFERSON,22051,193733,84477,105949,190426,55.637885582851084,44.362114417148916,181639,73670,100398,174068,57.67745938368913,42.32254061631087,-3.536171361623519,4.8191194837013285
LOUISIANA,LA,JEFFERSON DAVIS,22053,14841,3208,11423,14631,78.07395256646846,21.926047433531544,14277,3080,10775,13855,77.76975821003248,22.230241789967522,0.39114736041026,-1.3683807819547034
LOUISIANA,LA,LA SALLE,22059,7077,638,6378,7016,90.90649942987457,9.093500570125428,6569,605,5836,6441,90.60704859493868,9.392951405061327,0.33049397323887675,-3.1880377319373876
LOUISIANA,LA,LAFAYETTE,22055,114521,39685,72519,112204,64.63138569034972,35.36861430965028,105603,32726,68195,100921,67.57265583971622,32.42734416028379,-4.352752030855878,9.070339324824793
LOUISIANA,LA,LAFOURCHE,22057,45388,8672,36024,44696,80.59781635940577,19.402183640594238,41645,8423,31959,40382,79.141696795602,20.858303204398,1.8398892401365385,-6.98100679395981
LOUISIANA,LA,LINCOLN,22061,19275,7559,11311,18870,59.94170641229465,40.05829358770535,18669,7107,10761,17868,60.224983210208194,39.775016789791806,-0.4703642621614379,0.7121978085154357
LOUISIANA,LA,LIVINGSTON,22063,65230,9249,54877,64126,85.57683310981506,14.423166890184948,57730,6950,48824,55774,87.53899666511278,12.461003334887224,-2.241473663222493,15.746433112687086
LOUISIANA,LA,MADISON,22065,4670,2654,1930,4584,42.102966841186735,57.897033158813265,4732,2744,1927,4671,41.254549347034896,58.745450652965104,2.0565428724355073,-1.4442267183612412
LOUISIANA,LA,MOREHOUSE,22067,11574,4946,6510,11456,56.826117318435756,43.173882681564244,11852,5155,6502,11657,55.777644333876644,44.222355666123356,1.8797369395579189,-2.3709116548992326
LOUISIANA,LA,"NATCHITOCHES",22069,16554,6896,9358,16254,57.57352036421804,42.42647963578196,16621,7144,8968,16112,55.660377358490564,44.339622641509436,3.437172179781567,-4.314748055470474
LOUISIANA,LA,ORLEANS,22071,177819,147854,26664,174518,15.278653204827009,84.72134679517299,165812,133996,24292,158288,15.346709794804408,84.65329020519559,-0.44346046082424095,0.08039450068915155
LOUISIANA,LA,OUACHITA,22073,69166,25913,42255,68168,61.9865626100223,38.0134373899777,68017,24428,41734,66162,63.078504277379764,36.921495722620236,-1.7310836391360662,2.9574686669274985
LOUISIANA,LA,PLAQUEMINES,22075,11014,3414,7412,10826,68.46480694624053,31.535193053759468,10573,3347,6900,10247,67.33678149702352,32.663218502976484,1.675199533061833,-3.453503668397595
LOUISIANA,LA,POINTE COUPEE,22077,12371,4683,7503,12186,61.57065484982767,38.42934515017233,11761,4764,6789,11553,58.76395741365879,41.23604258634121,4.776222636626759,-6.8064180268805785
LOUISIANA,LA,RAPIDES,22079,58865,19475,38347,57822,66.31904811317492,33.680951886825085,56844,18322,36816,55138,66.77064819180964,33.22935180819036,-0.6763452068601072,1.3590396864840981
LOUISIANA,LA,RED RIVER,22081,4132,1644,2413,4057,59.47744638895736,40.52255361104264,4422,1938,2391,4329,55.23215523215523,44.76784476784477,7.686267426932836,-9.482902692361417
LOUISIANA,LA,RICHLAND,22083,9940,3225,6607,9832,67.19894222945484,32.80105777054516,9597,3157,6287,9444,66.5713680643795,33.4286319356205,0.9427088301211306,-1.8773552153853568
LOUISIANA,LA,SABINE,22085,10596,1731,8776,10507,83.52526886837346,16.474731131626534,9787,1703,7879,9582,82.22709246503861,17.772907534961387,1.5787696784813399,-7.304243274665046
LOUISIANA,LA,ST. BERNARD,22087,17650,6151,11179,17330,64.5066358915176,35.4933641084824,15815,4960,10237,15197,67.36197933802724,32.63802066197276,-4.238805739631424,8.748519023509482
LOUISIANA,LA,ST. CHARLES,22089,28517,9800,18233,28033,65.04120144115863,34.958798558841366,26192,8559,16621,25180,66.0087370929309,33.9912629070691,-1.4657690699491965,2.846424548618498
LOUISIANA,LA,ST. HELENA,22091,6158,3346,2714,6060,44.78547854785479,55.21452145214521,5964,3353,2497,5850,42.68376068376068,57.31623931623932,4.923928516199649,-3.6668802579631676
LOUISIANA,LA,ST. JAMES,22093,12590,6510,5954,12464,47.769576379974325,52.230423620025675,12085,6418,5456,11874,45.94913255853125,54.05086744146875,3.9618676568575983,-3.3680196222834358
LOUISIANA,LA,ST. JOHN THE BAPTIST,22095,21432,13582,7538,21120,35.691287878787875,64.30871212121212,20743,12661,7569,20230,37.4147305981216,62.5852694018784,-4.606321338634068,2.753751379205527
LOUISIANA,LA,ST. LANDRY,22097,41154,17372,23171,40543,57.15166613225464,42.84833386774536,39977,17209,21971,39180,56.077080142930065,43.922919857069935,1.9162659442782282,-2.44652676284135
LOUISIANA,LA,ST. MARTIN,22099,27038,8439,18203,26642,68.32445011635762,31.67554988364237,25750,8266,16873,25139,67.1188193643343,32.8811806356657,1.7962633482554669,-3.66662853558124
LOUISIANA,LA,ST. MARY,22101,23186,8055,14811,22866,64.7730254526371,35.2269745473629,22877,8050,14359,22409,64.07693337498327,35.92306662501674,1.0863380018207858,-1.9377301078440823
LOUISIANA,LA,ST. TAMMANY,22103,140110,37746,99666,137412,72.53078333769976,27.469216662300237,124392,27717,90915,118632,76.63615213433138,23.36384786566862,-5.356961019435769,17.571458349821476
LOUISIANA,LA,TANGIPAHOA,22105,57661,18887,37806,56693,66.68548145273667,33.31451854726333,52416,16878,33959,50837,66.79977181973759,33.20022818026241,-0.17109394820888912,0.3442457274100086
LOUISIANA,LA,TENSAS,22107,2554,1329,1197,2526,47.387173396674584,52.612826603325416,2548,1332,1182,2514,47.01670644391408,52.98329355608592,0.7879474782063411,-0.6992146540840127
LOUISIANA,LA,TERREBONNE,22109,46240,11198,34339,45537,75.40900805938028,24.590991940619716,43896,10665,31902,42567,74.94538022411727,25.054619775882728,0.6186209661977582,-1.8504684541622685
LOUISIANA,LA,UNION,22111,11201,2654,8407,11061,76.00578609528975,23.994213904710243,10894,2691,7972,10663,74.76319984994842,25.23680015005158,1.6620292441137163,-4.923707593487425
LOUISIANA,LA,VERMILION,22113,27324,5009,21930,26939,81.40613979731987,18.59386020268013,25632,4857,20063,24920,80.50963081861958,19.490369181380416,1.1135425284957812,-4.599753705828935
LOUISIANA,LA,VERNON,22115,17268,2898,14107,17005,82.95795354307556,17.042046456924435,16633,2665,13471,16136,83.48413485374319,16.515865146256818,-0.6302770120208412,3.185914307291804
LOUISIANA,LA,WASHINGTON,22117,19513,5970,13307,19277,69.03045079628573,30.96954920371427,18628,5692,12556,18248,68.8075405523893,31.192459447610698,0.3239619409542982,-0.7146286244943845
LOUISIANA,LA,WEBSTER,22119,18216,6172,11830,18002,65.71492056438174,34.285079435618265,18145,6260,11542,17802,64.83541175148859,35.1645882485114,1.3565253757688245,-2.501120748741792
LOUISIANA,LA,WEST BATON ROUGE,22121,14097,6200,7684,13884,55.34428118697782,44.65571881302218,12712,5383,6927,12310,56.27132412672624,43.72867587327376,-1.6474517956262646,2.11998859154805
LOUISIANA,LA,WEST CARROLL,22123,5052,710,4317,5027,85.87626815197932,14.123731848020688,4759,715,3970,4685,84.7385272145144,15.261472785485592,1.3426489400562014,-7.454987821011294
LOUISIANA,LA,WEST FELICIANA,22125,6268,2298,3863,6161,62.70086024995942,37.29913975004058,5799,2248,3390,5638,60.12770485987939,39.87229514012061,4.279483802144912,-6.453492032593955
LOUISIANA,LA,WINN,22127,6225,1543,4619,6162,74.95942875689711,25.04057124310289,6372,1644,4608,6252,73.70441458733205,26.295585412667947,1.702766620685936,-4.772718119294861
MAINE,ME,ANDROSCOGGIN,23001,59361,27617,29268,56885,51.45117342005801,48.54882657994199,55601,23009,28227,51236,55.09212272620813,44.90787727379187,-6.608838298434394,8.107596099348413
MAINE,ME,AROOSTOOK,23003,36210,13956,21080,35036,60.16668569471401,39.83331430528599,35097,13386,19419,32805,59.19524462734339,40.80475537265661,1.6410795723308613,-2.3807055292912827
MAINE,ME,CUMBERLAND,23005,195914,128759,59584,188343,31.635898334421775,68.36410166557823,171818,102981,57709,160690,35.91324911319933,64.08675088680067,-11.910230581742276,6.674313675743737
MAINE,ME,FRANKLIN,23007,17599,8069,8754,16823,52.03590322772395,47.96409677227605,16488,7016,7918,14934,53.01995446631847,46.98004553368153,-1.8560016667303003,2.0946153359707065
MAINE,ME,HANCOCK,23009,35676,19369,14982,34351,43.61445081657011,56.38554918342989,32130,16117,13705,29822,45.95600563342499,54.043994366575014,-5.095209613151841,4.332682741716565
MAINE,ME,KENNEBEC,23011,72615,34902,34721,69623,49.87001421943898,50.12998578056102,66208,29302,31675,60977,51.94581563540351,48.05418436459649,-3.9960897534733864,4.319710017789546
MAINE,ME,KNOX,23013,26032,15110,9982,25092,39.78160369838992,60.21839630161008,23147,12443,9148,21591,42.3695058126071,57.6304941873929,-6.107935564939126,4.490508281609196
MAINE,ME,LINCOLN,23015,23857,12684,10256,22940,44.707933740191805,55.292066259808195,21503,10241,9727,19968,48.712940705128204,51.287059294871796,-8.22164892318803,7.8090009838736485
MAINE,ME,OXFORD,23017,33810,14755,17698,32453,54.53424953008967,45.46575046991033,31201,12172,16210,28382,57.11366358959904,42.88633641040096,-4.516281914681997,6.014535806522758
MAINE,ME,PENOBSCOT,23019,86133,37713,44825,82538,54.308318592648234,45.691681407351766,80540,32838,41622,74460,55.89846897663175,44.10153102336825,-2.8447118733221033,3.6056580057071796
MAINE,ME,PISCATAQUIS,23021,9996,3517,6143,9660,63.59213250517598,36.40786749482402,9182,3098,5406,8504,63.57008466603951,36.42991533396049,0.03468272734306055,-0.06052124726163566
MAINE,ME,SAGADAHOC,23023,24280,13528,9755,23283,41.89752179701929,58.10247820298071,21616,10664,9304,19968,46.594551282051285,53.405448717948715,-10.080641095993004,8.795037955468764
MAINE,ME,SOMERSET,23025,27873,10199,16644,26843,62.00499199046306,37.99500800953694,26064,9092,15001,24093,62.26289793716017,37.73710206283983,-0.41422091685709983,0.6834280657471936
MAINE,ME,WALDO,23027,24566,12345,11196,23541,47.55957690837263,52.44042309162737,22707,10440,10378,20818,49.851090402536265,50.148909597463735,-4.596716893572806,4.569418383285306
MAINE,ME,WASHINGTON,23029,17570,6761,10194,16955,60.12385726924211,39.87614273075789,16365,6075,9093,15168,59.94857594936709,40.05142405063291,0.29238612777569006,-0.4376406682904177
MAINE,ME,YORK,23031,131042,71189,54817,126006,43.503483961081216,56.496516038918784,114274,55844,50403,106247,47.43945711408322,52.56054288591678,-8.296834307223854,7.488456048760894
MARYLAND,MD,ALLEGANY,24001,30641,9158,20886,30044,69.51804020769538,30.481959792304618,30654,7875,21270,29145,72.97992794647452,27.020072053525475,-4.743616273940665,12.812281669424518
MARYLAND,MD,ANNE ARUNDEL,24003,309617,172823,127821,300644,42.51573289338886,57.48426710661114,270081,128419,122403,250822,48.800743156501426,51.199256843498574,-12.878923263436526,12.275588847556996
MARYLAND,MD,BALTIMORE,24005,414932,258409,146202,404611,36.13396571027481,63.86603428972519,390682,218412,149477,367889,40.63100554786906,59.36899445213094,-11.068000353316643,7.574727985700003
MARYLAND,MD,BALTIMORE CITY,24510,237461,207260,25374,232634,10.907262051118925,89.09273794888108,239402,202673,25205,227878,11.060743029164728,88.93925697083527,-1.387619056342848,0.1725683160318514
MARYLAND,MD,CALVERT,24009,49113,22587,25346,47933,52.87797550747919,47.12202449252081,47408,18225,26176,44401,58.95362717055922,41.04637282944078,-10.305814849190732,14.801920959803372
MARYLAND,MD,CAROLINE,24011,15794,5095,10283,15378,66.86825334894004,33.131746651059956,14113,4009,9368,13377,70.03064962248635,29.969350377513642,-4.515731741164486,10.552101509411083
MARYLAND,MD,CARROLL,24013,100327,36456,60218,96674,62.28975732875437,37.71024267124563,91848,26567,58215,84782,68.66433912858862,31.335660871411385,-9.283686234708366,20.342898865266946
MARYLAND,MD,CECIL,24015,47462,16809,29439,46248,63.654644525168656,36.345355474831344,45269,13650,28868,42518,67.89594995060915,32.10405004939085,-6.246772345811246,13.211122643141305
MARYLAND,MD,CHARLES,24017,89498,62171,25579,87750,29.14985754985755,70.85014245014246,78303,49341,25614,74955,34.17250350210126,65.82749649789874,-14.697916270415678,7.630012106573192
MARYLAND,MD,DORCHESTER,24019,15977,6857,8764,15621,56.10396261442929,43.89603738557071,15225,6245,8413,14658,57.39527902851685,42.60472097148315,-2.2498652083318027,3.030923298269883
MARYLAND,MD,FREDERICK,24021,145615,77675,63682,141357,45.05047503837801,54.94952496162199,125677,56522,59522,116044,51.292613146737445,48.707386853262555,-12.169662891812472,12.815588171799686
MARYLAND,MD,GARRETT,24023,15611,3281,12002,15283,78.53170189098999,21.46829810901001,14011,2567,10776,13343,80.76144795023608,19.23855204976392,-2.760904015267307,11.589988963194608
MARYLAND,MD,HARFORD,24025,148186,63095,80930,144025,56.19163339697969,43.80836660302031,133672,47077,77860,124937,62.319408982126994,37.680591017873006,-9.832852533798464,16.262418979152216
MARYLAND,MD,HOWARD,24027,183062,129433,48390,177823,27.21245283231078,72.78754716768923,162193,102597,47484,150081,31.63891498590761,68.3610850140924,-13.990562431007625,6.475119803444218
MARYLAND,MD,KENT,24029,10794,5329,5195,10524,49.36335993918662,50.63664006081338,10021,4575,4876,9451,51.59242408210771,48.40757591789229,-4.320526089980969,4.604783653496658
MARYLAND,MD,MONTGOMERY,24031,533743,419569,101222,520791,19.436203774642802,80.5637962253572,478873,357837,92704,450541,20.57615178196879,79.42384821803121,-5.540141905081308,1.4352716884186156
MARYLAND,MD,PRINCE GEORGE'S,24033,424855,379208,37090,416298,8.909483110656309,91.09051688934369,390385,344049,32811,376860,8.70641617576819,91.29358382423182,2.3323825876058857,-0.222432865905553
MARYLAND,MD,QUEEN ANNE'S,24035,30290,10709,18741,29450,63.63667232597623,36.36332767402377,26523,7973,16993,24966,68.06456781222462,31.935432187775376,-6.505433926303617,13.865149719011338
MARYLAND,MD,SOMERSET,24039,10147,4241,5739,9980,57.50501002004008,42.49498997995992,9900,4196,5341,9537,56.002935933731784,43.997064066268216,2.6821345368137406,-3.414032545548673
MARYLAND,MD,ST MARY'S,24037,55665,23138,30826,53964,57.12326736342747,42.87673263657253,NA,NA,NA,NA,NA,NA,NA,NA
MARYLAND,MD,TALBOT,24041,22555,11062,10946,22008,49.73645946928389,50.26354053071611,20553,8653,10724,19377,55.34396449398772,44.65603550601228,-10.13209855125755,12.55710445668392
MARYLAND,MD,WASHINGTON,24043,67779,26044,40224,66268,60.69897989980081,39.30102010019919,65991,21129,40998,62127,65.990632092327,34.009367907672996,-8.018793008563218,15.559395890249172
MARYLAND,MD,WICOMICO,24045,46216,22054,22944,44998,50.98893284145962,49.01106715854038,42547,18050,22198,40248,55.15305108328364,44.84694891671636,-7.550114019142862,9.285176232517077
MARYLAND,MD,WORCESTER,24047,31691,12560,18571,31131,59.65436381741672,40.34563618258328,28273,9753,17210,26963,63.8282090271854,36.1717909728146,-6.5391858449153295,11.538950926996083
MASSACHUSETTS,MA,BARNSTABLE,25001,151512,91994,55311,147305,37.54862360408676,62.45137639591324,133862,72430,54099,126529,42.756206087142075,57.243793912857925,-12.17971134398984,9.097200110430848
MASSACHUSETTS,MA,BERKSHIRE,25003,71771,51705,18064,69769,25.891155097536156,74.10884490246384,64803,43714,16839,60553,27.80869651379783,72.19130348620217,-6.895473922376216,2.656194477258844
MASSACHUSETTS,MA,BRISTOL,25005,281364,153377,119872,273249,43.869144992296405,56.130855007703595,248959,129540,105443,234983,44.87260780567105,55.12739219432895,-2.236248041835065,1.820261712793081
MASSACHUSETTS,MA,DUKES,25007,12873,9914,2631,12545,20.972499003587085,79.02750099641291,11502,8400,2477,10877,22.77282338880206,77.22717661119795,-7.9055826959964826,2.3312057545218146
MASSACHUSETTS,MA,ESSEX,25009,424599,267198,144837,412035,35.15162546871018,64.84837453128982,379868,222310,136316,358626,38.01062945798687,61.98937054201313,-7.5215907498631385,4.612087466413306
MASSACHUSETTS,MA,FRANKLIN,25011,43003,30030,11201,41231,27.16645242657224,72.83354757342777,38177,24478,10364,34842,29.74570920153837,70.25429079846162,-8.671021280718838,3.6713156529688096
MASSACHUSETTS,MA,HAMPDEN,25013,220793,125948,87318,213266,40.94323520861272,59.05676479138728,203117,112590,78685,191275,41.137106260619525,58.862893739380475,-0.4712802373082803,0.32936038256152766
MASSACHUSETTS,MA,HAMPSHIRE,25015,88332,63362,22281,85643,26.016136753733523,73.98386324626648,82956,55367,21790,77157,28.241118757857357,71.75888124214265,-7.878519343376899,3.1006364168580935
MASSACHUSETTS,MA,MIDDLESEX,25017,869347,617196,226956,844152,26.885679356324452,73.11432064367554,784034,520360,219793,740153,29.69561698729857,70.30438301270142,-9.462465899179628,3.996817140784037
MASSACHUSETTS,MA,"NANTUCKET",25019,7338,5241,1914,7155,26.750524109014677,73.24947589098532,6406,4146,1892,6038,31.334879099039416,68.66512090096059,-14.630198430110664,6.67639542444991
MASSACHUSETTS,MA,NORFOLK,25021,411042,273312,125294,398606,31.433044158893743,68.56695584110625,361562,221819,119723,341542,35.05366836289534,64.94633163710466,-10.328802584992957,5.574794007200068
MASSACHUSETTS,MA,PLYMOUTH,25023,303870,173630,121227,294857,41.113828059025224,58.886171940974776,266863,135513,115369,250882,45.985363637088355,54.014636362911645,-10.593665446485922,9.018917660266057
MASSACHUSETTS,MA,SUFFOLK,25025,337240,270522,58613,329135,17.808194206024883,82.19180579397512,308741,245751,50421,296172,17.024229164134354,82.97577083586565,4.604995822907165,-0.9448120023389572
MASSACHUSETTS,MA,WORCESTER,25027,434921,248773,171683,420456,40.83257225488517,59.16742774511483,383705,198778,157682,356460,44.23553834932391,55.76446165067609,-7.6928330058195105,6.102392085762176
MICHIGAN,MI,ALCONA,26001,7064,2142,4848,6990,69.35622317596567,30.643776824034333,6198,1732,4201,5933,70.8073487274566,29.1926512725434,-2.049399642227012,4.970859062930533
MICHIGAN,MI,ALGER,26003,5128,2053,3014,5067,59.482928754687194,40.517071245312806,4518,1663,2585,4248,60.85216572504708,39.14783427495292,-2.2501039265333866,3.4976059230840573
MICHIGAN,MI,ALLEGAN,26005,67094,24449,41392,65841,62.86660287662703,37.13339712337297,55786,18050,34183,52233,65.44330212700783,34.55669787299217,-3.937300176846392,7.456439442944074
MICHIGAN,MI,ALPENA,26007,16969,6000,10686,16686,64.041711614527145,35.958288385472855,14698,4877,9090,13967,65.08197895038305,34.918021049616954,-1.5983953663255668,2.979170367008277
MICHIGAN,MI,ANTRIM,26009,15949,5960,9748,15708,62.05755029284441,37.94244970715559,13582,4448,8469,12917,65.56475961910661,34.4352403808934,-5.3492292912184265,10.184942191395852
MICHIGAN,MI,ARENAC,26011,8831,2774,5928,8702,68.12227074235808,31.87772925764192,7696,2384,4950,7334,67.49386419416416,32.50613580583583,0.9310572978695308,-1.933193634418684
MICHIGAN,MI,BARAGA,26013,4038,1478,2512,3990,62.957393483709275,37.042606516290725,3490,1156,2158,3314,65.11768255884128,34.88231744115872,-3.3175152896142146,6.193077850335182
MICHIGAN,MI,BARRY,26015,35905,11797,23471,35268,66.5504139730067,33.44958602699331,30329,9114,19202,28316,67.8132504591044,32.186749540895605,-1.8622267441069873,3.9234669673406497
MICHIGAN,MI,BAY,26017,60255,26151,33125,59276,55.882650651191035,44.117349348808965,52977,21642,28328,49970,56.69001400840504,43.30998599159496,-1.4241720898045762,1.8641505849729123
MICHIGAN,MI,BENZIE,26019,12262,5480,6601,12081,54.639516596308255,45.360483403691745,10228,4108,5539,9647,57.41681351715559,42.58318648284441,-4.8370795081087214,6.5220504857386175
MICHIGAN,MI,BERRIEN,26021,82391,37438,43519,80957,53.75569746902677,46.24430253097323,72031,29495,38647,68142,56.715388453523524,43.28461154647648,-5.218497245984876,6.837744128346412
MICHIGAN,MI,BRANCH,26023,20536,6159,14064,20223,69.5445779557929,30.45542204420709,17663,5061,11786,16847,69.95904315308364,30.040956846916366,-0.5924397742030463,1.3796670971659486
MICHIGAN,MI,CALHOUN,26025,66281,28877,36221,65098,55.64072628959415,44.35927371040585,58902,24157,31494,55651,56.59197498697238,43.40802501302762,-1.6808897332125539,2.191412065148657
MICHIGAN,MI,CASS,26027,26216,9130,16699,25829,64.65213519687174,35.34786480312827,22595,7270,14243,21513,66.20647980290987,33.79352019709013,-2.347722776781458,4.599534458005294
MICHIGAN,MI,CHARLEVOIX,26029,17000,6939,9841,16780,58.64719904648391,41.35280095351609,14589,5137,8674,13811,62.80501049887771,37.19498950112229,-6.620190681232496,11.178418136852386
MICHIGAN,MI,CHEBOYGAN,26031,15868,5437,10186,15623,65.19874543941624,34.80125456058376,13672,4302,8683,12985,66.86946476703889,33.13053523296111,-2.498478690450312,5.042838323844756
MICHIGAN,MI,CHIPPEWA,26033,17642,6648,10681,17329,61.63656298690057,38.36343701309943,15456,5379,9122,14501,62.90600648231157,37.09399351768843,-2.0180004524177675,3.4222346397015935
MICHIGAN,MI,CLARE,26035,16281,5199,10861,16060,67.62764632627646,32.37235367372354,13389,4249,8505,12754,66.68496158068056,33.31503841931943,1.4136391822845429,-2.829607259432809
MICHIGAN,MI,CLINTON,26037,47927,21968,25098,47066,53.325117919517275,46.674882080482725,40655,16492,21636,38128,56.745698699118755,43.254301300881245,-6.027911996886914,7.9080708200730765
MICHIGAN,MI,CRAWFORD,26039,7861,2672,5087,7759,65.56257249645573,34.43742750354427,6844,2110,4354,6464,67.35767326732673,32.64232673267327,-2.665027878481896,5.499303972943204
MICHIGAN,MI,DELTA,26041,21151,7606,13207,20813,63.455532599817424,36.544467400182576,18492,6436,11121,17557,63.342256649769325,36.657743350230675,0.1788315668550089,-0.30900961078224043
MICHIGAN,MI,DICKINSON,26043,14589,4744,9617,14361,66.9660887124852,33.0339112875148,13165,3923,8580,12503,68.62353035271535,31.37646964728465,-2.415267229347029,5.282435082283343
MICHIGAN,MI,EATON,26045,64327,31299,31798,63097,50.395422920265624,49.604577079734376,56221,24938,27609,52547,52.541534245532574,47.458465754467426,-4.084599652606125,4.522083238784291
MICHIGAN,MI,EMMET,26047,22177,9662,12135,21797,55.67279900903794,44.32720099096206,18802,6972,10616,17588,60.35933591084831,39.64066408915169,-7.76439440740776,11.822548914090758
MICHIGAN,MI,GENESEE,26049,221360,119390,98714,218104,45.26005942119356,54.73994057880644,196296,102751,84175,186926,45.03118881268524,54.96881118731476,0.508249092557489,-0.41636448663299186
MICHIGAN,MI,GLADWIN,26051,14603,4524,9893,14417,68.62037871956717,31.379621280432822,12472,3794,8124,11918,68.16579963081054,31.83420036918946,0.6668726710735484,-1.4279582445444472
MICHIGAN,MI,GOGEBIC,26053,8266,3570,4600,8170,56.303549571603426,43.696450428396574,7329,2925,4018,6943,57.8712372173412,42.1287627826588,-2.7089236745538536,3.7211813074726097
MICHIGAN,MI,GRAND TRAVERSE,26055,60236,28683,30502,59185,51.536706935879025,48.463293064120975,51589,20965,27413,48378,56.664186200338996,43.335813799661004,-9.048888916063348,11.83196717653443
MICHIGAN,MI,GRATIOT,26057,19127,6693,12102,18795,64.38946528332004,35.610534716679965,16465,5666,9880,15546,63.55332561430593,36.44667438569407,1.3156505358798753,-2.2941453043581417
MICHIGAN,MI,HILLSDALE,26059,23302,5883,17037,22920,74.33246073298429,25.667539267015705,19940,4799,14095,18894,74.60040224409866,25.399597755901343,-0.35916898978325396,1.0549045449040895
MICHIGAN,MI,HOUGHTON,26061,18501,7750,10378,18128,57.24845542806708,42.75154457193292,15624,6018,8475,14493,58.47650589939971,41.52349410060029,-2.100074983011657,2.9574834631146185
MICHIGAN,MI,HURON,26063,18437,5490,12731,18221,69.86993030020307,30.130069699796937,15917,4579,10692,15271,70.01506122716259,29.984938772837403,-0.2072852960717242,0.4840127507313996
MICHIGAN,MI,INGHAM,26065,144550,94212,47639,141851,33.58383092117786,66.41616907882215,131138,79110,43868,122978,35.671420904552036,64.32857909544796,-5.852275940899743,3.2451983437667975
MICHIGAN,MI,IONIA,26067,32209,10901,20657,31558,65.4572533113632,34.5427466886368,26854,8352,16635,24987,66.57461880177692,33.42538119822308,-1.6783655851498436,3.3428653626637495
MICHIGAN,MI,IOSCO,26069,15363,5373,9759,15132,64.49246629659001,35.50753370340999,13361,4345,8345,12690,65.76044129235619,34.239558707643816,-1.9281728815186194,3.703245729867155
MICHIGAN,MI,IRON,26071,6789,2493,4216,6709,62.840959904605754,37.159040095394246,5910,2004,3675,5679,64.7120972002113,35.2879027997887,-2.891479918841877,5.3024893721276944
MICHIGAN,MI,ISABELLA,26073,29421,14072,14815,28887,51.286045626060165,48.713954373939835,25392,11404,12338,23742,51.96697835060231,48.03302164939769,-1.310318102292074,1.4176345796281575
MICHIGAN,MI,JACKSON,26075,80861,31995,47372,79367,59.68727556793126,40.31272443206874,69677,25795,39793,65588,60.671159358419224,39.328840641580776,-1.6216663747524618,2.5016852122707656
MICHIGAN,MI,KALAMAZOO,26077,143414,83686,56823,140509,40.44082585457159,59.55917414542841,126299,67148,51034,118182,43.182548949924694,56.817451050075306,-6.349146037054121,4.825494711011791
MICHIGAN,MI,KALKASKA,26079,10631,3002,7436,10438,71.23970109216324,28.76029890783675,8833,2280,6116,8396,72.84421152929967,27.155788470700333,-2.2026601749832286,5.908539311490069
MICHIGAN,MI,KENT,26081,361048,187915,165741,353656,46.865032687131,53.134967312869,308184,138683,148180,286863,51.65531978679718,48.34468021320282,-9.273560050422047,9.908612650948845
MICHIGAN,MI,KEWEENAW,26083,1557,672,862,1534,56.19295958279009,43.80704041720991,1434,527,814,1341,60.70096942580164,39.29903057419836,-7.426586240145561,11.471045919314026
MICHIGAN,MI,LAKE,26085,6323,2288,3946,6234,63.29804299005454,36.70195700994546,5328,1939,3159,5098,61.96547665751275,38.03452334248725,2.150497994079781,-3.5035704813295654
MICHIGAN,MI,LAPEER,26087,52650,16367,35482,51849,68.43333526201084,31.56666473798916,45183,12734,30037,42771,70.22749058941807,29.772509410581936,-2.5547763594411688,6.026214662206253
MICHIGAN,MI,LEELANAU,26089,16900,8795,7916,16711,47.36999581114236,52.63000418885764,14757,6774,7239,14013,51.659173624491544,48.340826375508456,-8.302838610092845,8.872785458881328
MICHIGAN,MI,LENAWEE,26091,53375,20918,31541,52459,60.12505003907814,39.87494996092186,45939,16750,26430,43180,61.208893006021306,38.791106993978694,-1.7707279346426796,2.7940501082152736
MICHIGAN,MI,LIVINGSTON,26093,127197,48220,76982,125202,61.486238239005765,38.513761760994235,105866,34384,65680,100064,65.6379916853214,34.362008314678604,-6.325229245617036,12.082394626923199
MICHIGAN,MI,LUCE,26095,3001,842,2109,2951,71.46729922060318,28.532700779396816,2579,681,1756,2437,72.05580631924498,27.944193680755028,-0.8167379267597141,2.1060085159912534
MICHIGAN,MI,MACKINAC,26097,7015,2632,4304,6936,62.05305651672434,37.94694348327566,6097,2085,3744,5829,64.23057128152342,35.76942871847658,-3.390153195516521,6.087641997128923
MICHIGAN,MI,MACOMB,26099,494256,223952,263863,487815,54.090792616053214,45.909207383946786,419312,176317,224665,400982,56.02869954262286,43.97130045737714,-3.458775488971355,4.407208580169519
MICHIGAN,MI,MANISTEE,26101,14655,6107,8321,14428,57.672581092320485,42.327418907679515,12599,4979,6915,11894,58.13855725575921,41.86144274424079,-0.8014924783716793,1.1131392825748598
MICHIGAN,MI,MARQUETTE,26103,37462,20465,16286,36751,44.31444042338984,55.68555957661016,32976,16042,14646,30688,47.72549530761209,52.27450469238791,-7.147238309914828,6.525274422579019
MICHIGAN,MI,MASON,26105,17254,6802,10207,17009,60.009406784643424,39.990593215356576,14685,5281,8505,13786,61.693021906281736,38.306978093718264,-2.729020348842537,4.39506117532773
MICHIGAN,MI,MECOSTA,26107,21049,7375,13267,20642,64.27187288053483,35.72812711946517,17168,5827,10305,16132,63.87924621869576,36.12075378130424,0.6146388460735341,-1.0869835779625636
MICHIGAN,MI,MENOMINEE,26109,12607,4316,8117,12433,65.28593259872919,34.71406740127081,10768,3539,6702,10241,65.44282784884288,34.55717215115711,-0.23974399528712276,0.45401646126430606
MICHIGAN,MI,MIDLAND,26111,49088,20493,27675,48168,57.455156950672645,42.544843049327355,42506,15635,23846,39481,60.39867277931157,39.60132722068843,-4.873477666295956,7.43287166168809
MICHIGAN,MI,MISSAUKEE,26113,8755,1967,6648,8615,77.1677307022635,22.832269297736506,7317,1565,5386,6951,77.48525392029924,22.514746079700764,-0.4097853487869396,1.4102900246431016
MICHIGAN,MI,MONROE,26115,87148,32975,52710,85685,61.516017972807376,38.483982027192624,74218,26863,43261,70124,61.69214534253608,38.30785465746392,-0.2854939940097445,0.4597682937443892
MICHIGAN,MI,MONTCALM,26117,32100,9703,21815,31518,69.21441715844914,30.78558284155086,26609,7874,16907,24781,68.22565675315766,31.77434324684234,1.4492501096307953,-3.111820117288311
MICHIGAN,MI,MONTMORENCY,26119,5859,1628,4171,5799,71.92619417140887,28.073805828591137,5009,1287,3498,4785,73.10344827586206,26.896551724137932,-1.6103947655256023,4.376970388351653
MICHIGAN,MI,MUSKEGON,26121,92444,45643,45133,90776,49.71908874592403,50.28091125407597,78088,37304,36127,73431,49.198567362558045,50.801432637441955,1.0580010989550193,-1.0246194966209488
MICHIGAN,MI,NEWAYGO,26123,27161,7873,18857,26730,70.54620276842499,29.45379723157501,22640,6212,15173,21385,70.95160158989947,29.04839841010054,-0.5713737426502163,1.395597842439078
MICHIGAN,MI,OAKLAND,26125,770351,434148,325971,760119,42.884206288752154,57.115793711247846,664614,343070,289203,632273,45.74021032054192,54.25978967945808,-6.243967860609367,5.263573723123005
MICHIGAN,MI,OCEANA,26127,14062,4944,8892,13836,64.2671292281006,35.73287077189939,11930,3973,7228,11201,64.52995268279618,35.47004731720382,-0.4072890863371814,0.7409729463994763
MICHIGAN,MI,OGEMAW,26129,11907,3475,8253,11728,70.37005457025921,29.62994542974079,10387,3030,6827,9857,69.26042406411688,30.739575935883128,1.6021133585828462,-3.6097781845033095
MICHIGAN,MI,ONTONAGON,26131,3804,1391,2358,3749,62.89677247265938,37.10322752734062,3426,1176,2066,3242,63.72609500308452,36.27390499691548,-1.3013860811414757,2.286278608535963
MICHIGAN,MI,OSCEOLA,26133,12329,3214,8928,12142,73.52989622796903,26.470103772030967,10609,2705,7336,10041,73.06045214620057,26.93954785379942,0.6425419881457284,-1.7425833733963225
MICHIGAN,MI,OSCODA,26135,4874,1342,3466,4808,72.08818635607321,27.911813643926788,4073,1044,2843,3887,73.14124003087214,26.858759969127863,-1.4397536524598853,3.920708461631617
MICHIGAN,MI,OTSEGO,26137,14757,4743,9779,14522,67.33920947527889,32.660790524721115,12538,3556,8266,11822,69.92048722720352,30.07951277279648,-3.691733073221992,8.581514505976662
MICHIGAN,MI,OTTAWA,26139,168713,64705,100913,165618,60.9311789781304,39.0688210218696,142734,44973,88467,133440,66.29721223021583,33.70278776978417,-8.093904813752928,15.921630248332995
MICHIGAN,MI,PRESQUE ISLE,26141,8344,2911,5342,8253,64.72797770507694,35.27202229492306,7218,2400,4488,6888,65.15679442508711,34.84320557491289,-0.6581304740263083,1.2307039864291935
MICHIGAN,MI,ROSCOMMON,26143,15018,5166,9670,14836,65.1792936101375,34.820706389862494,13041,4287,8141,12428,65.5053105889926,34.4946894110074,-0.4976954935770883,0.945122233079343
MICHIGAN,MI,SAGINAW,26145,103349,51088,50785,101873,49.851285424008324,50.148714575991676,94320,44396,45469,89865,50.597006621042674,49.402993378957326,-1.473844495623211,1.5094656133771478
MICHIGAN,MI,SANILAC,26151,22446,5966,16194,22160,73.07761732851985,26.922382671480143,19249,4873,13446,18319,73.39920301326491,26.600796986735084,-0.43813239319089314,1.208932517719008
MICHIGAN,MI,SCHOOLCRAFT,26153,4745,1589,3090,4679,66.03975208377858,33.96024791622141,4154,1369,2556,3925,65.12101910828025,34.87898089171974,1.4108086576020806,-2.6340591152892223
MICHIGAN,MI,SHIAWASSEE,26155,39224,15347,23149,38496,60.13352036575228,39.86647963424772,34111,12546,19230,31776,60.51737160120846,39.48262839879154,-0.6342827279176011,0.9722028421692563
MICHIGAN,MI,ST. CLAIR,26147,92064,31363,59185,90548,65.36312232186243,34.636877678137566,78003,24553,49051,73604,66.64175860007609,33.35824139992392,-1.9186712731980582,3.833044622719717
MICHIGAN,MI,ST. JOSEPH,26149,27936,9262,18127,27389,66.18350432655446,33.816495673445544,23757,7526,14884,22410,66.41677822400715,33.58322177599286,-0.35122736105313024,0.6946144089708506
MICHIGAN,MI,TUSCOLA,26157,29445,8712,20297,29009,69.9679409838326,30.032059016167395,25796,7429,17102,24531,69.71586971586972,30.284130284130285,0.36156942313165796,-0.8323543241886777
MICHIGAN,MI,VAN BUREN,26159,39066,16803,21591,38394,56.235349273323955,43.764650726676045,33274,13258,17890,31148,57.435469372030305,42.564530627969695,-2.089510387619087,2.819530912242074
MICHIGAN,MI,WASHTENAW,26161,216418,157136,56241,213377,26.35757368413653,73.64242631586347,188578,128483,50631,179114,28.267472112732673,71.73252788726732,-6.7565236147729575,2.662527705140527
MICHIGAN,MI,WAYNE,26163,872469,597170,264553,861723,30.700468712103543,69.29953128789646,777838,519444,228993,748437,30.596162402446698,69.4038375975533,0.3409130474758548,-0.15028896566452454
MICHIGAN,MI,WEXFORD,26165,18265,5838,12102,17940,67.45819397993311,32.541806020066886,15298,4436,10000,14436,69.27126627874758,30.728733721252425,-2.6173511705685604,5.900250609938129
MINNESOTA,MN,AITKIN,27001,10025,3607,6258,9865,63.4363912823112,36.5636087176888,9231,3134,5516,8650,63.76878612716763,36.23121387283237,-0.5212500739681158,0.9174267415469561
MINNESOTA,MN,ANOKA,27003,211132,100893,104902,205795,50.97402755168979,49.02597244831021,185758,75500,93339,168839,55.282843418878336,44.717156581121664,-7.794128522913757,9.635710757619176
MINNESOTA,MN,BECKER,27005,19401,6589,12438,19027,65.37026331003311,34.62973668996689,17222,5208,10880,16088,67.62804574838388,32.37195425161611,-3.3385297672966163,6.9745015107886665
MINNESOTA,MN,BELTRAMI,27007,24189,11426,12188,23614,51.613449648513594,48.386550351486406,21564,8688,10783,19471,55.379795593446666,44.620204406553334,-6.80093868995566,8.4408980080331375
MINNESOTA,MN,BENTON,27009,22260,7280,14382,21662,66.39276151786538,33.60723848213461,20058,5640,12872,18512,69.533275713051,30.466724286949006,-4.51656298797981,10.308013968311336
MINNESOTA,MN,BIG STONE,27011,2974,1053,1863,2916,63.888888888888886,36.111111111111114,2755,921,1608,2529,63.58244365361803,36.41755634638197,0.4819651741293507,-0.8414766558089037
MINNESOTA,MN,BLUE EARTH,27013,36051,18330,16731,35061,47.71968854282536,52.28031145717464,33593,14428,15667,30095,52.05848147532813,47.94151852467187,-8.334459264930805,9.05017835484272
MINNESOTA,MN,BROWN,27015,14635,4753,9552,14305,66.77385529535128,33.226144704648725,13779,3763,8708,12471,69.82599631144255,30.174003688557452,-4.371066905336951,10.115134363984657
MINNESOTA,MN,CARLTON,27017,20369,10098,9791,19889,49.228216602141885,50.771783397858115,18211,8460,8160,16620,49.09747292418773,50.90252707581227,0.2662941087742787,-0.2568510552716452
MINNESOTA,MN,CARVER,27019,66361,30774,34009,64783,52.496796999212755,47.503203000787245,55696,21508,29056,50564,57.46380824301875,42.53619175698125,-8.643720970945967,11.677141367482147
MINNESOTA,MN,CASS,27021,18289,6342,11620,17962,64.6921278254092,35.307872174590806,15999,4949,9982,14931,66.85419596812002,33.14580403187998,-3.2340051531572156,6.522901482888521
MINNESOTA,MN,CHIPPEWA,27023,6611,2226,4250,6476,65.62693020382953,34.373069796170476,6222,1978,3764,5742,65.55207244862417,34.44792755137583,0.114195863546529,-0.2173069921077464
MINNESOTA,MN,CHISAGO,27025,34570,11806,21916,33722,64.99021410355257,35.009785896447426,30228,9278,18441,27719,66.52837403946751,33.471625960532485,-2.3120359667928025,4.59541444962559
MINNESOTA,MN,CLAY,27027,32239,16357,15043,31400,47.90764331210191,52.09235668789809,29398,12971,13543,26514,51.07867541676096,48.92132458323904,-6.208133000290184,6.4819015667974655
MINNESOTA,MN,CLEARWATER,27029,4708,1260,3372,4632,72.79792746113989,27.202072538860104,4245,1100,2925,4025,72.67080745341615,27.32919254658385,0.17492582259421852,-0.4651436646255225
MINNESOTA,MN,COOK,27031,3806,2496,1203,3699,32.522303325223035,67.47769667477696,3395,1912,1156,3068,37.67926988265971,62.32073011734029,-13.686482178387305,8.274881484422437
MINNESOTA,MN,COTTONWOOD,27033,6107,1834,4165,5999,69.42823803967327,30.57176196032672,5721,1678,3679,5357,68.67649803994773,31.32350196005227,1.0946102686952175,-2.399923229159573
MINNESOTA,MN,CROW WING,27035,40173,13726,25676,39402,65.16420486269733,34.835795137302675,35842,10982,22287,33269,66.99029126213593,33.00970873786408,-2.7258970890170264,5.531967621828682
MINNESOTA,MN,DAKOTA,27037,262259,146155,109638,255793,42.86200169668443,57.13799830331557,231440,110483,99583,210066,47.405577294754984,52.594422705245016,-9.58447477565738,8.638892423126542
MINNESOTA,MN,DODGE,27039,12187,4079,7783,11862,65.6128814702411,34.387118529758894,10654,3102,6527,9629,67.78481669955343,32.21518330044657,-3.2041618389839654,6.741961419422426
MINNESOTA,MN,DOUGLAS,27041,24165,7868,15799,23667,66.75539781129844,33.24460218870157,21785,6227,13966,20193,69.16258109245778,30.83741890754222,-3.4804705711335204,7.806046570812719
MINNESOTA,MN,FARIBAULT,27043,7914,2531,5191,7722,67.22351722351722,32.77648277648278,7412,2153,4659,6812,68.39401056958309,31.605989430416912,-1.7113974400945864,3.703390930515882
MINNESOTA,MN,FILLMORE,27045,12141,4551,7301,11852,61.60141748228147,38.39858251771853,11055,3872,6271,10143,61.825889776200334,38.174110223799666,-0.36307167552528385,0.5880223339925328
MINNESOTA,MN,FREEBORN,27047,16818,6889,9578,16467,58.16481447743973,41.83518552256027,16051,6041,8808,14849,59.31712573237255,40.68287426762745,-1.942628272536051,2.832423410775964
MINNESOTA,MN,GOODHUE,27049,28636,11806,16052,27858,57.62079115514394,42.37920884485606,25717,9446,14041,23487,59.7820070677396,40.2179929322604,-3.6151611807659134,5.373753772933965
MINNESOTA,MN,GRANT,27051,3654,1300,2269,3569,63.575231157186884,36.424768842813116,3473,1105,2063,3168,65.1199494949495,34.880050505050505,-2.372112309273844,4.428658546635256
MINNESOTA,MN,HENNEPIN,27053,755969,532623,205973,738596,27.887099307334456,72.11290069266555,679977,429288,191770,621058,30.8779534278602,69.1220465721398,-9.686050364423405,4.326917776377348
MINNESOTA,MN,HOUSTON,27055,11440,4853,6334,11187,56.61929024760883,43.38070975239117,10604,4145,5616,9761,57.53508861796947,42.46491138203053,-1.591721490934872,2.1566002154620456
MINNESOTA,MN,HUBBARD,27057,12965,4462,8202,12664,64.7662665824384,35.233733417561595,11505,3423,7261,10684,67.96143766379633,32.03856233620367,-4.701447160615357,9.972891566820952
MINNESOTA,MN,ISANTI,27059,24235,7138,16491,23629,69.79135807693936,30.208641923060647,21016,5657,13635,19292,70.67696454488907,29.323035455110926,-1.2530341019204916,3.0201732331069486
MINNESOTA,MN,ITASCA,27061,26561,10786,15239,26025,58.5552353506244,41.4447646493756,23880,9015,12920,21935,58.90129929336677,41.09870070663323,-0.587531933750296,0.842031345984906
MINNESOTA,MN,JACKSON,27063,5819,1745,3948,5693,69.34832250131741,30.65167749868259,5484,1492,3609,5101,70.75083316996667,29.249166830033328,-1.9823238904904006,4.79504485306963
MINNESOTA,MN,KANABEC,27065,9242,2774,6278,9052,69.35483870967742,30.64516129032258,8177,2327,5230,7557,69.2073574169644,30.792642583035597,0.2131005982853429,-0.4789497761204409
MINNESOTA,MN,KANDIYOHI,27067,23367,8440,14437,22877,63.107050749661234,36.892949250338766,21772,7266,12785,20051,63.76240586504414,36.23759413495586,-1.0278080108363397,1.8084951030199026
MINNESOTA,MN,KITTSON,27069,2639,1006,1546,2552,60.57993730407524,39.42006269592476,2385,823,1349,2172,62.10865561694291,37.89134438305709,-2.4613611382865774,4.034478949633757
MINNESOTA,MN,KOOCHICHING,27071,6922,2659,4131,6790,60.83946980854197,39.16053019145803,6363,2306,3569,5875,60.748936170212765,39.251063829787235,0.1490291748904582,-0.23065269955944157
MINNESOTA,MN,LAC QUI PARLE,27073,4040,1446,2528,3974,63.61348766985405,36.38651233014595,3860,1305,2293,3598,63.729849916620346,36.270150083379654,-0.18258672650026675,0.32082096847902974
MINNESOTA,MN,LAKE,27075,7202,3647,3393,7040,48.19602272727273,51.80397727272727,6521,3077,2932,6009,48.79347645198868,51.20652354801132,-1.224454103621475,1.166753146512245
MINNESOTA,MN,LAKE OF THE WOODS,27077,2408,671,1704,2375,71.74736842105263,28.25263157894737,2242,553,1540,2093,73.57859531772576,26.421404682274247,-2.488803827751207,6.930846102598265
MINNESOTA,MN,LE SUEUR,27079,16818,5672,10775,16447,65.51346750167204,34.48653249832796,14971,4623,9182,13805,66.51213328504166,33.48786671495835,-1.501479104706771,2.982171996413041
MINNESOTA,MN,LINCOLN,27081,3115,937,2121,3058,69.35905820797907,30.64094179202093,3019,860,1931,2791,69.18667144392691,30.813328556073092,0.24916181173981755,-0.5594551842669659
MINNESOTA,MN,LYON,27083,12893,4634,7979,12613,63.26012843891223,36.73987156108777,12215,3825,7256,11081,65.48145474235177,34.51854525764823,-3.392298341843103,6.435167782591766
MINNESOTA,MN,MAHNOMEN,27087,2304,1112,1142,2254,50.66548358473824,49.33451641526176,2088,930,991,1921,51.58771473191047,48.41228526808953,-1.787695291339908,1.9049527244277886
MINNESOTA,MN,MARSHALL,27089,5113,1295,3721,5016,74.18261562998406,25.817384370015947,4817,1225,3208,4433,72.36634333408527,27.63365666591473,2.509830139563385,-6.572681704260663
MINNESOTA,MN,MARTIN,27091,11009,3305,7480,10785,69.35558646267965,30.644413537320354,10531,2733,7062,9795,72.0980091883614,27.90199081163859,-3.8037426505313943,9.82877080060478
MINNESOTA,MN,MCLEOD,27085,20933,6413,13986,20399,68.56218442080494,31.437815579195057,18807,4978,12155,17133,70.9449600186774,29.055039981322594,-3.358625612369315,8.200902836148828
MINNESOTA,MN,MEEKER,27093,13529,3867,9359,13226,70.76213518826553,29.23786481173446,12282,3191,8104,11295,71.7485613103143,28.251438689685703,-1.3748374936501495,3.4915960666063173
MINNESOTA,MN,MILLE LACS,27095,14689,4404,9952,14356,69.32293117860128,30.67706882139872,13017,3710,8340,12050,69.2116182572614,30.78838174273859,0.16082982040113158,-0.3615419682332699
MINNESOTA,MN,MORRISON,27097,19558,4367,14821,19188,77.24098394830102,22.75901605169898,17614,3637,12925,16562,78.04009177635551,21.959908223644486,-1.0239708973492023,3.638939743810421
MINNESOTA,MN,MOWER,27099,19345,8899,10025,18924,52.97505812724582,47.02494187275418,17715,7437,8823,16260,54.2619926199262,45.7380073800738,-2.3717051854225124,2.8137091368808376
MINNESOTA,MN,MURRAY,27101,4896,1449,3363,4812,69.88778054862843,30.112219451371573,4668,1295,2974,4269,69.66502693839307,30.334973061606934,0.31974955013274187,-0.734312866482445
MINNESOTA,MN,NICOLLET,27103,19125,9622,9018,18640,48.37982832618026,51.62017167381974,18097,7886,8437,16323,51.687802487287875,48.312197512712125,-6.399912555619247,6.847078649728577
MINNESOTA,MN,NOBLES,27105,8715,2933,5600,8533,65.62756357670222,34.372436423297785,8632,2733,5299,8032,65.97360557768924,34.02639442231076,-0.5245158241041326,1.0169811020592112
MINNESOTA,MN,NORMAN,27107,3441,1404,1953,3357,58.1769436997319,41.8230563002681,3261,1264,1699,2963,57.340533243334455,42.659466756665545,1.4586722673958885,-1.9606678657481225
MINNESOTA,MN,OLMSTED,27109,91385,49491,39692,89183,44.506239978471235,55.493760021528765,80129,36268,35668,71936,49.582962633451956,50.417037366548044,-10.238844928470703,10.069458500846284
MINNESOTA,MN,OTTER TAIL,27111,36399,11958,23800,35758,66.55853235639577,33.44146764360423,32500,9340,20939,30279,69.15353875623369,30.846461243766306,-3.752528715826553,8.412655115705814
MINNESOTA,MN,PENNINGTON,27113,7277,2568,4532,7100,63.83098591549296,36.16901408450704,6715,2147,4000,6147,65.07239303725395,34.927606962746054,-1.9077323943661906,3.554228960160577
MINNESOTA,MN,PINE,27115,16001,5419,10256,15675,65.42902711323764,34.57097288676236,13811,4580,8191,12771,64.13749902121995,35.86250097878005,2.0136863952091133,-3.601333026890363
MINNESOTA,MN,PIPESTONE,27117,4940,1306,3553,4859,73.12204157233998,26.877958427660012,4808,1127,3338,4465,74.75923852183651,25.240761478163495,-2.1899593707315756,6.486321543479989
MINNESOTA,MN,POLK,27119,15594,5439,9865,15304,64.46027182435965,35.539728175640356,14796,4712,8979,13691,65.58322985903148,34.41677014096852,-1.7122639996315803,3.2628222522691264
MINNESOTA,MN,POPE,27121,7022,2477,4417,6894,64.0702059762112,35.9297940237888,6319,2106,3793,5899,64.29903373453128,35.70096626546872,-0.3558805553203648,0.6409567646392
MINNESOTA,MN,RAMSEY,27123,295977,211620,77376,288996,26.77407299755014,73.22592700244986,273143,177738,70894,248632,28.513626564561278,71.48637343543872,-6.100779790576261,2.4334058134620307
MINNESOTA,MN,RED LAKE,27125,2196,691,1454,2145,67.78554778554779,32.214452214452216,1881,540,1141,1681,67.87626412849494,32.123735871505055,-0.13364958150232642,0.2823966157299518
MINNESOTA,MN,REDWOOD,27127,8284,2355,5771,8126,71.01895151365986,28.981048486340143,7611,1887,5137,7024,73.13496583143508,26.86503416856492,-2.8933004804464035,7.876462410203056
MINNESOTA,MN,RENVILLE,27129,8128,2496,5467,7963,68.65502951149064,31.344970488509357,7606,2117,4890,7007,69.78735550164122,30.212644498358785,-1.6225374668681125,3.747854611707635
MINNESOTA,MN,RICE,27131,35686,17402,17464,34866,50.08891183387828,49.91108816612172,32443,14437,15429,29866,51.660751356057055,48.339248643942945,-3.0426183919496586,3.2516838103062495
MINNESOTA,MN,ROCK,27133,5240,1556,3583,5139,69.72173574625414,30.278264253745863,4839,1373,3091,4464,69.24283154121864,30.75716845878136,0.6916300133544162,-1.5570490686660277
MINNESOTA,MN,ROSEAU,27135,8421,2188,6065,8253,73.48842845026051,26.51157154973949,7804,1856,5451,7307,74.59969891884494,25.400301081155057,-1.489644709951632,4.375028725186669
MINNESOTA,MN,SAINT LOUIS,27137,119531,67704,49017,116721,41.99501375073894,58.00498624926106,112422,57771,44630,102401,43.58355875430904,56.41644124569096,-3.6448262807658893,2.8157483323913546
MINNESOTA,MN,SCOTT,27139,87965,40040,45872,85912,53.39417077940218,46.60582922059782,75029,28502,39948,68450,58.36084733382031,41.63915266617969,-8.510288628965679,11.927900152618086
MINNESOTA,MN,SHERBURNE,27141,55612,18065,36222,54287,66.7231565568184,33.27684344318161,48283,13293,31053,44346,70.02435394398593,29.97564605601407,-4.714356079326687,11.0129315678426
MINNESOTA,MN,SIBLEY,27143,8452,2417,5864,8281,70.81270377973675,29.187296220263253,7774,1954,5193,7147,72.65985728277599,27.34014271722401,-2.5421925835203973,6.756195540543231
MINNESOTA,MN,STEARNS,27145,84835,31879,50959,82838,61.51645380139549,38.48354619860451,79592,25576,47617,73193,65.05676772368942,34.943232276310574,-5.441884136221509,10.131615456461528
MINNESOTA,MN,STEELE,27147,21128,7917,12656,20573,61.51752296699558,38.48247703300442,19179,6241,11198,17439,64.21239749985665,35.78760250014336,-4.196813446915892,7.530190190444497
MINNESOTA,MN,STEVENS,27149,5085,1922,3044,4966,61.29681836488119,38.70318163511881,5398,2116,2799,4915,56.94811800610376,43.05188199389624,7.636249468878553,-10.10106912258557
MINNESOTA,MN,SWIFT,27151,5193,1784,3316,5100,65.01960784313725,34.98039215686274,4994,1686,2963,4649,63.73413637341364,36.26586362658636,2.0169277295798427,-3.5445770241667285
MINNESOTA,MN,TODD,27153,13257,3286,9753,13039,74.79868088043561,25.201319119564385,11993,2783,8485,11268,75.30173943911963,24.69826056088037,-0.6680570228935201,2.0368177647328345
MINNESOTA,MN,TRAVERSE,27155,1864,661,1172,1833,63.93889798145117,36.06110201854883,1798,630,1049,1679,62.47766527695057,37.52233472304943,2.33880811330458,-3.894301128343669
MINNESOTA,MN,WABASHA,27157,13123,4696,8153,12849,63.45240874776247,36.54759125223753,11832,3866,6989,10855,64.38507600184246,35.61492399815753,-1.4485767696434837,2.6187540204444915
MINNESOTA,MN,WADENA,27159,7677,2023,5520,7543,73.18043218878431,26.8195678112157,6934,1684,4837,6521,74.17573991719061,25.824260082809385,-1.3418237951080214,3.854157777278844
MINNESOTA,MN,WASECA,27161,10389,3496,6624,10120,65.45454545454545,34.54545454545455,9653,2838,5967,8805,67.76831345826236,32.23168654173765,-3.414232825997543,7.178550836056119
MINNESOTA,MN,WASHINGTON,27163,166786,89165,73764,162929,45.27370817963653,54.72629182036347,144235,67086,64428,131514,48.98946119804736,51.01053880195264,-7.5848007459999085,7.284284984397371
MINNESOTA,MN,WATONWAN,27165,5201,1987,3103,5090,60.96267190569745,39.03732809430255,4998,1814,2768,4582,60.41030117852466,39.58969882147534,0.9143651271335651,-1.395238518139863
MINNESOTA,MN,WILKIN,27167,3430,1026,2328,3354,69.40966010733453,30.590339892665472,3302,893,2129,3022,70.45003309066843,29.54996690933157,-1.4767530087529512,3.520724698359534
MINNESOTA,MN,WINONA,27169,27173,13333,13227,26560,49.80045180722892,50.19954819277108,26074,11366,12122,23488,51.60933242506812,48.39066757493188,-3.50494868435961,3.73807741965575
MINNESOTA,MN,WRIGHT,27171,82426,28430,51973,80403,64.64062286233101,35.35937713766899,69618,20334,43274,63608,68.03232297824174,31.96767702175827,-4.985424526802451,10.609779727198255
MINNESOTA,MN,YELLOW MEDICINE,27173,5528,1688,3734,5422,68.86757654002213,31.13242345997787,5276,1524,3382,4906,68.93599673868732,31.064003261312678,-0.09925177251668416,0.2202555739182488
MISSISSIPPI,MS,ADAMS,28001,13759,7917,5696,13613,41.84235657092485,58.15764342907515,13836,7757,5874,13631,43.09294989362483,56.90705010637517,-2.902083347246065,2.1976070106643597
MISSISSIPPI,MS,ALCORN,28003,15793,2782,12818,15600,82.16666666666667,17.833333333333332,14783,2684,11819,14503,81.49348410673653,18.50651589326346,0.8260569140085217,-3.6375434674615015
MISSISSIPPI,MS,AMITE,28005,7196,2620,4503,7123,63.21774533202302,36.78225466797698,7050,2697,4289,6986,61.39421700543945,38.60578299456055,2.970195590933278,-4.723458987583551
MISSISSIPPI,MS,ATTALA,28007,8823,3542,5178,8720,59.38073394495413,40.61926605504587,8256,3242,4897,8139,60.16709669492567,39.83290330507433,-1.3069647584272759,1.9741537390556285
MISSISSIPPI,MS,BENTON,28009,4289,1679,2570,4249,60.48481995763709,39.51518004236291,4013,1719,2251,3970,56.70025188916877,43.29974811083123,6.67469357255408,-8.740392805014107
MISSISSIPPI,MS,BOLIVAR,28011,13744,8904,4671,13575,34.408839779005525,65.59116022099448,13824,9046,4590,13636,33.66089762393664,66.33910237606337,2.221991116888744,-1.1274529324031946
MISSISSIPPI,MS,CALHOUN,28013,6590,1902,4625,6527,70.85950666462386,29.14049333537613,6396,1910,4390,6300,69.68253968253968,30.317460317460316,1.689041454927187,-3.8821424016389328
MISSISSIPPI,MS,CARROLL,28015,5701,1729,3924,5653,69.41447019281797,30.585529807182027,5528,1680,3799,5479,69.33747034130316,30.662529658696844,0.11105085192146813,-0.25112034907719405
MISSISSIPPI,MS,CHICKASAW,28017,8141,3810,4175,7985,52.28553537883531,47.71446462116469,7890,3649,4127,7776,53.07355967078189,46.92644032921811,-1.4847775367522575,1.679275662969748
MISSISSIPPI,MS,CHOCTAW,28019,4223,1185,3001,4186,71.69135212613473,28.308647873865265,4065,1218,2788,4006,69.59560659011483,30.404393409885174,3.0113187293026256,-6.892903626679603
MISSISSIPPI,MS,CLAIBORNE,28021,4449,3772,603,4375,13.782857142857143,86.21714285714286,4272,3708,540,4248,12.711864406779661,87.28813559322033,8.425142857142864,-1.2269625520110794
MISSISSIPPI,MS,CLARKE,28023,8338,2838,5417,8255,65.62083585705633,34.37916414294367,7791,2585,5137,7722,66.52421652421653,33.47578347578347,-1.3579726517054747,2.698609482325365
MISSISSIPPI,MS,CLAY,28025,10189,5844,4181,10025,41.70573566084788,58.29426433915212,10003,5722,4150,9872,42.03808752025932,57.96191247974068,-0.7905970014722263,0.5733969863875865
MISSISSIPPI,MS,COAHOMA,28027,8501,6020,2375,8395,28.29064919594997,71.70935080405003,8912,6378,2426,8804,27.555656519763744,72.44434348023626,2.6673023582619804,-1.014561856560603
MISSISSIPPI,MS,COPIAH,28029,12883,6470,6250,12720,49.13522012578616,50.86477987421384,12982,6741,6103,12844,47.51635004671442,52.48364995328558,3.4069748149430534,-3.084522666606948
MISSISSIPPI,MS,COVINGTON,28031,9360,3416,5854,9270,63.14994606256742,36.85005393743258,8811,3276,5435,8711,62.392377453794055,37.607622546205945,1.2142005797653788,-2.014401755502082
MISSISSIPPI,MS,DESOTO,28033,76124,28265,46462,74727,62.1756527091948,37.8243472908052,65695,20591,43089,63680,67.66488693467336,32.33511306532663,-8.112382173605203,16.976078649821535
MISSISSIPPI,MS,FORREST,28035,31654,13755,17290,31045,55.693348365276215,44.306651634723785,28064,11716,15461,27177,56.890017294035395,43.109982705964605,-2.1034778783318164,2.7758510990857133
MISSISSIPPI,MS,FRANKLIN,28037,4461,1480,2923,4403,66.38655462184875,33.61344537815126,4290,1502,2721,4223,64.43286762964718,35.56713237035283,3.0321279559232694,-5.492956170484165
MISSISSIPPI,MS,GEORGE,28039,11049,1218,9713,10931,88.85737809898454,11.142621901015461,9891,1027,8696,9723,89.43741643525661,10.562583564743392,-0.6485410238699751,5.491443761999348
MISSISSIPPI,MS,GREENE,28041,5812,966,4794,5760,83.22916666666667,16.770833333333332,5369,974,4335,5309,81.65379544170277,18.34620455829723,1.9293300653594914,-8.586905373032172
MISSISSIPPI,MS,GRENADA,28043,10911,4734,6081,10815,56.22746185852982,43.77253814147018,10513,4424,5970,10394,57.43698287473543,42.56301712526457,-2.105822687176062,2.84171822839987
MISSISSIPPI,MS,HANCOCK,28045,20957,4504,16132,20636,78.17406474122892,21.82593525877108,17637,3344,13811,17155,80.50714077528417,19.492859224715826,-2.8979740325984937,11.968875407959878
MISSISSIPPI,MS,HARRISON,28047,75768,27728,46822,74550,62.80617035546613,37.19382964453387,63313,21169,40354,61523,65.59172992214293,34.40827007785706,-4.246815215856092,8.095610620277638
MISSISSIPPI,MS,HINDS,28049,99995,73550,25141,98691,25.47446069043783,74.52553930956216,94681,67594,25275,92869,27.21575552660199,72.78424447339802,-6.398113160820151,2.392406280730941
MISSISSIPPI,MS,HOLMES,28051,8115,6588,1369,7957,17.20497675003142,82.79502324996858,8076,6689,1309,7998,16.366591647911978,83.63340835208803,5.122539378725199,-1.002452391501174
MISSISSIPPI,MS,HUMPHREYS,28053,4189,3016,1118,4134,27.044025157232703,72.95597484276729,4253,3071,1151,4222,27.261961155850308,72.7380388441497,-0.7994142364583179,0.2996176444687304
MISSISSIPPI,MS,ISSAQUENA,28055,676,355,308,663,46.45550527903469,53.54449472096531,699,395,298,693,43.001443001443,56.998556998557,8.032433417352491,-6.059911793344408
MISSISSIPPI,MS,ITAWAMBA,28057,10819,1249,9438,10687,88.31290352765042,11.687096472349584,9737,1117,8470,9587,88.34880567435069,11.651194325649318,-0.040636821772777054,0.30814134325465314
MISSISSIPPI,MS,JACKSON,28059,54543,17375,36295,53670,67.62623439537917,32.37376560462083,49567,14657,33629,48286,69.6454458849356,30.354554115064406,-2.8992728295435977,6.652087465697032
MISSISSIPPI,MS,JASPER,28061,8736,4341,4302,8643,49.77438389448108,50.22561610551892,8475,4368,4038,8406,48.037116345467524,51.962883654532476,3.616510900695391,-3.343285489241754
MISSISSIPPI,MS,JEFFERSON,28063,3908,3327,531,3858,13.763608087091757,86.23639191290825,3860,3337,490,3827,12.803762738437419,87.19623726156259,7.4965880597962276,-1.1007875784537546
MISSISSIPPI,MS,JEFFERSON DAVIS,28065,6213,3599,2534,6133,41.3174629055927,58.6825370944073,6237,3720,2466,6186,39.86420950533463,60.13579049466537,3.645509137873648,-2.416619767203343
MISSISSIPPI,MS,JONES,28067,30091,8517,21226,29743,71.36469085162895,28.635309148371046,28352,7791,20133,27924,72.09926944563816,27.90073055436184,-1.018843324845431,2.632829246452717
MISSISSIPPI,MS,KEMPER,28069,4731,2887,1787,4674,38.232777064612755,61.767222935387245,4639,2827,1778,4605,38.610206297502714,61.389793702497286,-0.9775374676368132,0.6148077882767167
MISSISSIPPI,MS,LAFAYETTE,28071,23423,10070,12949,23019,56.253529692862415,43.746470307137585,19643,7969,10872,18841,57.70394352741362,42.29605647258638,-2.513543695435916,3.4291940088818196
MISSISSIPPI,MS,LAMAR,28073,28485,7340,20704,28044,73.82684353159321,26.173156468406788,24592,5190,18751,23941,78.32170753101374,21.678292468986257,-5.7389760018200064,20.734400579985923
MISSISSIPPI,MS,LAUDERDALE,28075,31247,12960,17967,30927,58.09486856145116,41.90513143854884,29506,11269,17741,29010,61.15477421578766,38.84522578421234,-5.0035433759259345,7.877173043952612
MISSISSIPPI,MS,LAWRENCE,28077,6613,2260,4285,6545,65.46982429335371,34.5301757066463,6364,2195,4091,6286,65.08113267578746,34.918867324212535,0.5972416299245831,-1.1131277940871875
MISSISSIPPI,MS,LEAKE,28079,9200,3897,5228,9125,57.293150684931504,42.706849315068496,8449,3584,4782,8366,57.15993306239541,42.84006693760459,0.23306119408970094,-0.31096501956946465
MISSISSIPPI,MS,LEE,28081,36954,12189,24207,36396,66.5100560501154,33.489943949884605,32913,10029,22220,32249,68.90136128252038,31.098638717479613,-3.4706211719094715,7.689420923305268
MISSISSIPPI,MS,LEFLORE,28083,10893,7648,3129,10777,29.03405400389719,70.96594599610282,11140,7787,3212,10999,29.2026547867988,70.7973452132012,-0.5773474505401,0.23814562875752454
MISSISSIPPI,MS,LINCOLN,28085,16801,5040,11596,16636,69.70425583072854,30.295744169271458,15193,4458,10550,15008,70.29584221748401,29.704157782515992,-0.8415666817465417,1.991594547426212
MISSISSIPPI,MS,LOWNDES,28087,27241,13087,13800,26887,51.32591958939264,48.67408041060736,25575,11819,13271,25090,52.893583100836985,47.106416899163015,-2.963806608555386,3.3279192403874003
MISSISSIPPI,MS,MADISON,28089,56212,24440,31091,55531,55.988546937746484,44.011453062253516,49802,20343,28265,48608,58.148864384463465,41.851135615536535,-3.715149847869059,5.161908786807201
MISSISSIPPI,MS,MARION,28091,12177,3787,8273,12060,68.59867330016584,31.40132669983416,11693,3677,7836,11513,68.06219056718493,31.93780943281508,0.7882243114866405,-1.6797731043810993
MISSISSIPPI,MS,MARSHALL,28093,15817,8057,7566,15623,48.42859886065416,51.57140113934584,14839,8023,6587,14610,45.08555783709788,54.91444216290212,7.4148822459628505,-6.087726455709497
MISSISSIPPI,MS,MONROE,28095,17259,5874,11177,17051,65.55040760072723,34.44959239927277,15884,5524,10167,15691,64.79510547447582,35.20489452552419,1.1656777479109648,-2.1454463546363267
MISSISSIPPI,MS,MONTGOMERY,28097,5075,2121,2917,5038,57.899960301707026,42.100039698292974,4996,2115,2818,4933,57.125481451449424,42.874518548550576,1.3557502371613683,-1.8063849495606354
MISSISSIPPI,MS,NESHOBA,28099,11703,3260,8320,11580,71.84801381692573,28.151986183074268,10553,2715,7679,10394,73.8791610544545,26.120838945545508,-2.749283029935412,7.775964783378986
MISSISSIPPI,MS,NEWTON,28101,10183,3075,6997,10072,69.46981731532962,30.530182684670372,9438,2756,6548,9304,70.37833190025795,29.621668099742045,-1.2909009923905201,3.0670608483937434
MISSISSIPPI,MS,NOXUBEE,28103,5339,4040,1240,5280,23.484848484848484,76.51515151515152,5574,4347,1200,5547,21.63331530557058,78.36668469442942,8.558712121212109,-2.362653449609975
MISSISSIPPI,MS,OKTIBBEHA,28105,19757,10299,9004,19303,46.645599129668966,53.354400870331034,18124,8859,8576,17435,49.188414109549754,50.811585890450246,-5.169540482068746,5.00439995193831
MISSISSIPPI,MS,PANOLA,28107,15627,7403,8060,15463,52.124426049278924,47.875573950721076,15064,7431,7449,14880,50.060483870967744,49.939516129032256,4.122896981241819,-4.1328838128475764
MISSISSIPPI,MS,PEARL RIVER,28109,24033,4148,19595,23743,82.52958766794424,17.470412332055762,21883,3604,17782,21386,83.14785373608903,16.85214626391097,-0.7435742961052982,3.668767517576166
MISSISSIPPI,MS,PERRY,28111,5916,1362,4500,5862,76.76560900716478,23.23439099283521,5432,1220,4135,5355,77.21755368814192,22.782446311858077,-0.5852874889075155,1.9837407923217532
MISSISSIPPI,MS,PIKE,28113,17342,8646,8479,17125,49.512408759124085,50.487591240875915,16310,8043,8009,16052,49.894094193869925,50.105905806130075,-0.7649912097066114,0.761757378905914
MISSISSIPPI,MS,PONTOTOC,28115,14361,2614,11550,14164,81.54476136684552,18.455238633154476,12984,2386,10336,12722,81.24508725043232,18.754912749567676,0.3688519842307114,-1.59784329799193
MISSISSIPPI,MS,PRENTISS,28117,10644,2153,8370,10523,79.54005511736197,20.45994488263803,9872,2067,7648,9715,78.72362326299537,21.276376737004632,1.0370862271406267,-3.8372692139194697
MISSISSIPPI,MS,QUITMAN,28119,3226,2150,1026,3176,32.304785894206546,67.69521410579345,3365,2312,1001,3313,30.21430727437368,69.78569272562632,6.918836830675601,-2.9955690603400864
MISSISSIPPI,MS,RANKIN,28121,70655,18847,50895,69742,72.97611195549311,27.023888044506897,62768,14110,47178,61288,76.97754862289518,23.022451377104815,-5.198186664795845,17.380584725140945
MISSISSIPPI,MS,SCOTT,28123,10733,4330,6285,10615,59.2086669806877,40.7913330193123,10522,4268,6122,10390,58.92204042348412,41.07795957651588,0.486450494829338,-0.6977624014398387
MISSISSIPPI,MS,SHARKEY,28125,2183,1465,688,2153,31.95541105434278,68.04458894565722,2190,1479,692,2171,31.874712114233073,68.12528788576692,0.25317543204939064,-0.11845665921443871
MISSISSIPPI,MS,SIMPSON,28127,11815,4037,7635,11672,65.41295407813571,34.58704592186429,11419,3874,7393,11267,65.61640188160113,34.383598118398865,-0.31005632377180126,0.5917001553032764
MISSISSIPPI,MS,SMITH,28129,8327,1791,6458,8249,78.28827736695357,21.71172263304643,7627,1617,5928,7545,78.56858846918489,21.431411530815108,-0.3567724808257955,1.3079451245116447
MISSISSIPPI,MS,STONE,28131,7878,1802,5964,7766,76.79629152716971,23.203708472830286,7045,1573,5306,6879,77.13330425934002,22.86669574065998,-0.43692246223134834,1.473814739096957
MISSISSIPPI,MS,SUNFLOWER,28133,9681,6781,2799,9580,29.217118997912316,70.78288100208768,9598,6725,2794,9519,29.351822670448577,70.64817732955143,-0.45892779487211044,0.1906682912821589
MISSISSIPPI,MS,TALLAHATCHIE,28135,5685,3105,2488,5593,44.48417664938316,55.51582335061684,5870,3337,2462,5799,42.455595792378,57.544404207622,4.778123635163656,-3.525244348148915
MISSISSIPPI,MS,TATE,28137,13093,4183,8707,12890,67.54848719937937,32.451512800620634,11627,3926,7495,11421,65.62472638122756,34.37527361877244,2.931457278734051,-5.5963505614140985
MISSISSIPPI,MS,TIPPAH,28139,10102,1937,8054,9991,80.61255129616654,19.38744870383345,9235,1842,7240,9082,79.71812376128607,20.281876238713938,1.121987689473003,-4.409984186636596
MISSISSIPPI,MS,TISHOMINGO,28141,9138,1059,7933,8992,88.22286476868328,11.777135231316725,8371,999,7166,8165,87.7648499693815,12.235150030618493,0.5218658716577007,-3.7434342705695123
MISSISSIPPI,MS,TUNICA,28143,3562,2580,926,3506,26.41186537364518,73.58813462635482,3567,2667,853,3520,24.232954545454547,75.76704545454545,8.991519478582678,-2.8758028178594075
MISSISSIPPI,MS,UNION,28145,12683,2160,10373,12533,82.76549908242241,17.234500917577595,11496,2012,9235,11247,82.11078509824843,17.88921490175158,0.7973544320524883,-3.659825139167394
MISSISSIPPI,MS,WALTHALL,28147,7119,2835,4220,7055,59.81573352232459,40.18426647767541,6919,2790,4056,6846,59.246275197195445,40.753724802804555,0.9611715221484518,-1.3973160192953915
MISSISSIPPI,MS,WARREN,28149,21053,10442,10365,20807,49.814966117172105,50.185033882827895,19416,9284,9767,19051,51.2676499921264,48.7323500078736,-2.8335292824566705,2.980943612855902
MISSISSIPPI,MS,WASHINGTON,28151,18008,12503,5300,17803,29.77026343874628,70.22973656125372,16825,11380,5244,16624,31.54475457170356,68.45524542829644,-5.6253128516937085,2.5921916163692327
MISSISSIPPI,MS,WAYNE,28153,10056,3624,6307,9931,63.50820662571745,36.49179337428255,9599,3524,5990,9514,62.959848644103424,37.040151355896576,0.8709645804801047,-1.4804420650044947
MISSISSIPPI,MS,WEBSTER,28155,5395,1043,4291,5334,80.44619422572178,19.553805774278214,5069,1019,3976,4995,79.5995995995996,20.4004004004004,1.0635664379980536,-4.149892205574412
MISSISSIPPI,MS,WILKINSON,28157,4127,2749,1324,4073,32.50675178001473,67.49324821998528,4218,2857,1318,4175,31.568862275449103,68.4311377245509,2.970932231837242,-1.3705595665248316
MISSISSIPPI,MS,WINSTON,28159,9236,4040,5112,9152,55.85664335664335,44.14335664335665,8881,3850,4910,8760,56.050228310502284,43.949771689497716,-0.3453776366200034,0.44046862228681594
MISSISSIPPI,MS,YALOBUSHA,28161,6535,2785,3671,6456,56.86183395291202,43.13816604708798,6077,2582,3376,5958,56.66330983551527,43.33669016448473,0.35035743230149574,-0.45809709196352744
MISSISSIPPI,MS,YAZOO,28163,10436,5496,4832,10328,46.78543764523625,53.21456235476375,10070,5369,4598,9967,46.13223638005418,53.86776361994582,1.4159323640864807,-1.2126014174091426
MISSOURI,MO,ADAIR,29001,10336,3710,6413,10123,63.35078534031414,36.64921465968586,10226,3500,6030,9530,63.27387198321091,36.72612801678909,0.12155626752798909,-0.20942408376964927
MISSOURI,MO,ANDREW,29003,9752,2351,7255,9606,75.52571309598167,24.47428690401832,9140,2045,6665,8710,76.52123995407578,23.478760045924226,-1.3009810853713,4.2401168381416054
MISSOURI,MO,ATCHISON,29005,2814,564,2199,2763,79.58740499457112,20.41259500542888,2724,541,2060,2601,79.20030757401,20.799692425990003,0.4887574713007048,-1.8610728112374852
MISSOURI,MO,AUDRAIN,29007,10656,2704,7732,10436,74.08968953622077,25.910310463779226,10061,2570,6981,9551,73.09182284577531,26.90817715422469,1.3652234293718202,-3.708414303674945
MISSOURI,MO,BARRY,29009,15598,2948,12425,15373,80.823521758928,19.176478241072008,14605,2710,11428,14138,80.8318008204838,19.168199179516197,-0.010242332190768533,0.04319165028636718
MISSOURI,MO,BARTON,29011,6077,844,5168,6012,85.96141051230872,14.038589487691285,5939,795,4959,5754,86.18352450469239,13.816475495307612,-0.25772210368534276,1.6076024052523952
MISSOURI,MO,BATES,29013,8416,1672,6597,8269,79.77990083444189,20.220099165558107,8023,1618,6001,7619,78.76361727260796,21.236382727392048,1.2902956936531762,-4.78557753869765
MISSOURI,MO,BENTON,29015,10476,2180,8109,10289,78.81232384099523,21.187676159004763,9312,2025,7213,9238,78.07967092444252,21.92032907555748,0.9383401695707727,-3.342344515118023
MISSOURI,MO,BOLLINGER,29017,5983,750,5167,5917,87.32465776575968,12.675342234240324,5676,705,4827,5532,87.25596529284165,12.74403470715835,0.07872524553191873,-0.5390166811099606
MISSOURI,MO,BOONE,29019,91168,50064,38646,88710,43.56442340209672,56.43557659790328,83868,41125,36200,77325,46.81538958939541,53.18461041060459,-6.9442254263224035,6.112606940616927
MISSOURI,MO,BUCHANAN,29021,36598,13445,22450,35895,62.543529739518036,37.456470260481964,35659,12013,21320,33333,63.960639606396064,36.039360393603936,-2.215596772638151,3.932117139153024
MISSOURI,MO,BUTLER,29023,18141,3301,14602,17903,81.56174942747026,18.438250572529743,17259,3036,13650,16686,81.80510607695074,18.194893923049264,-0.2974834471231702,1.3374996881525991
MISSOURI,MO,CALDWELL,29025,4682,897,3725,4622,80.59281696235396,19.40718303764604,4312,838,3232,4070,79.41031941031942,20.58968058968059,1.4890980930633013,-5.743156368473301
MISSOURI,MO,CALLAWAY,29027,21144,5870,14815,20685,71.62194827169446,28.378051728305536,19193,4989,13057,18046,72.35398426244043,27.64601573755957,-1.011742474458277,2.6478896550414355
MISSOURI,MO,CAMDEN,29029,24812,5652,18850,24502,76.93249530650559,23.06750469349441,22514,4768,16944,21712,78.0397936624908,21.960206337509213,-1.4188893947799097,5.042294862657415
MISSOURI,MO,CAPE GIRARDEAU,29031,40328,10760,28907,39667,72.87417752791994,27.125822472080067,37038,8492,27017,35509,76.08493621335437,23.91506378664564,-4.219966323466373,13.425674771678175
MISSOURI,MO,CARROLL,29033,4532,786,3706,4492,82.50222617987534,17.497773820124667,4361,745,3480,4225,82.36686390532545,17.633136094674555,0.16434069252106998,-0.7676585368768807
MISSOURI,MO,CARTER,29035,2897,418,2451,2869,85.43046357615894,14.56953642384106,2844,436,2324,2760,84.20289855072464,15.797101449275363,1.457865520739543,-7.7708244729327465
MISSOURI,MO,CASS,29037,57408,19052,37197,56249,66.12917562978897,33.870824370211025,50990,14846,33098,47944,69.03470715835141,30.96529284164859,-4.20879822362068,9.383187633396028
MISSOURI,MO,CEDAR,29039,7044,1145,5788,6933,83.48478292225587,16.515217077744122,6288,1011,5021,6032,83.2393899204244,16.760610079575596,0.29480394085787953,-1.4641054273466403
MISSOURI,MO,CHARITON,29041,4077,916,3111,4027,77.25353861435312,22.746461385646885,3969,888,2950,3838,76.86294945284003,23.13705054715998,0.508163119283811,-1.688154506629791
MISSOURI,MO,CHRISTIAN,29043,46839,11131,34920,46051,75.82897222644459,24.171027773555405,41531,8508,30946,39454,78.43564657575911,21.56435342424089,-3.3233286944307827,12.087885493400918
MISSOURI,MO,CLARK,29045,3394,678,2672,3350,79.76119402985074,20.238805970149254,3215,724,2458,3182,77.24701445631678,22.752985543683216,3.2547271777807474,-11.049888678156172
MISSOURI,MO,CLAY,29047,126569,59400,64605,124005,52.098705697350916,47.901294302649084,110176,45304,57476,102780,55.92138548355711,44.07861451644289,-6.835810223854699,8.672413659417998
MISSOURI,MO,CLINTON,29049,10888,2896,7799,10695,72.92192613370734,27.07807386629266,10208,2572,7067,9639,73.31673410104783,26.683265898952172,-0.5384963912827057,1.4796088636061189
MISSOURI,MO,COLE,29051,39529,12694,26086,38780,67.26663228468283,32.73336771531717,37374,10913,24616,35529,69.28424667173294,30.71575332826705,-2.912082448712361,6.568663205122682
MISSOURI,MO,COOPER,29053,8693,2249,6272,8521,73.60638422720338,26.393615772796622,7986,1932,5624,7556,74.43091582848068,25.56908417151932,-1.1077810773917673,3.2247209002335797
MISSOURI,MO,CRAWFORD,29055,10973,2113,8725,10838,80.50378298579074,19.496217014209265,9696,1824,7724,9548,80.89652283200671,19.103477167993297,-0.48548421176464185,2.0558552914857753
MISSOURI,MO,DADE,29057,4119,656,3414,4070,83.88206388206389,16.117936117936118,3951,637,3184,3821,83.32897147343627,16.671028526563727,0.6637456323386193,-3.3176861748290376
MISSOURI,MO,DALLAS,29059,8104,1380,6619,7999,82.74784348043505,17.252156519564945,7453,1272,5895,7167,82.2519882796149,17.748011720385097,0.6028488930073017,-2.7938633838663796
MISSOURI,MO,DAVIESS,29061,3911,746,3102,3848,80.61330561330561,19.386694386694387,3593,730,2767,3497,79.12496425507578,20.875035744924222,1.8810009865304345,-7.129766753054434
MISSOURI,MO,DEKALB,29063,4843,930,3828,4758,80.45397225725094,19.546027742749054,4594,824,3540,4364,81.11824014665444,18.881759853345553,-0.8188884376714389,3.5180401327146615
MISSOURI,MO,DENT,29065,7142,1056,5987,7043,85.00638932273179,14.99361067726821,6791,978,5600,6578,85.13225904530252,14.867740954697476,-0.14785197054825172,0.846596150378609
MISSOURI,MO,DOUGLAS,29067,7000,1016,5898,6914,85.30517789991322,14.69482210008678,6666,984,5486,6470,84.79134466769706,15.208655332302937,0.6059972680347414,-3.3785579394700616
MISSOURI,MO,DUNKLIN,29069,10419,2200,8135,10335,78.71311078858248,21.286889211417513,10578,2360,8026,10386,77.27710379356826,22.722896206431734,1.8582567468499622,-6.319647733143096
MISSOURI,MO,FRANKLIN,29071,53685,14569,38058,52627,72.31649153476353,27.683508465236475,50113,12341,35430,47771,74.16633522429926,25.83366477570074,-2.4941824130062518,7.160593379208469
MISSOURI,MO,GASCONADE,29073,7923,1601,6222,7823,79.53470535600154,20.465294643998465,7445,1520,5670,7190,78.85952712100139,21.140472878998608,0.8561783967638625,-3.193770730033574
MISSOURI,MO,GENTRY,29075,3237,613,2581,3194,80.80776455854728,19.192235441452723,3043,605,2304,2909,79.20247507734616,20.79752492265383,2.0268173180616467,-7.718656364981857
MISSOURI,MO,GREENE,29077,141800,55068,83630,138698,60.2964714703889,39.7035285296111,129231,42728,78035,120763,64.61830196334971,35.3816980366503,-6.688245221008849,12.214875861763375
MISSOURI,MO,GRUNDY,29079,4437,799,3585,4384,81.77463503649635,18.22536496350365,4310,780,3462,4242,81.61244695898161,18.38755304101839,0.19872958544699948,-0.8820536215609187
MISSOURI,MO,HARRISON,29081,3826,597,3198,3795,84.26877470355731,15.731225296442688,3689,574,2965,3539,83.78072901949703,16.219270980502966,0.582527378040254,-3.009048215835064
MISSOURI,MO,HENRY,29083,10788,2619,8027,10646,75.3992109712568,24.60078902874319,9866,2357,7075,9432,75.01060220525869,24.989397794741308,0.5180717852854011,-1.5550945612618827
MISSOURI,MO,HICKORY,29085,5080,1056,3966,5022,78.97252090800478,21.02747909199522,4724,1016,3542,4558,77.70952172005265,22.290478279947344,1.6252824106961716,-5.666092813667101
MISSOURI,MO,HOLT,29087,2343,338,1976,2314,85.3932584269663,14.606741573033707,2355,347,1926,2273,84.73383194016718,15.26616805983282,0.7782328164560814,-4.319528543211481
MISSOURI,MO,HOWARD,29089,5092,1413,3553,4966,71.54651631091421,28.453483689085783,4868,1283,3277,4560,71.8640350877193,28.135964912280702,-0.44183265859969456,1.1285156837343546
MISSOURI,MO,HOWELL,29091,18650,3218,15181,18399,82.5099190173379,17.4900809826621,17455,2881,13893,16774,82.82460951472517,17.17539048527483,-0.3799480604026573,1.8322174256071078
MISSOURI,MO,IRON,29093,4592,945,3596,4541,79.18960581369743,20.810394186302577,4269,933,3173,4106,77.27715538236727,22.72284461763273,2.4747940343654573,-8.416421726732704
MISSOURI,MO,JACKSON,29095,196418,92182,100142,192324,52.06942451280131,47.93057548719869,173275,71237,91557,162794,56.24101625367028,43.75898374632972,-7.417347727241208,9.533109281174434
MISSOURI,MO,JASPER,29097,52352,13549,37728,51277,73.57684731946097,26.423152680539033,48326,10572,35070,45642,76.83712370185356,23.162876298146443,-4.243100503141218,14.075438388683569
MISSOURI,MO,JEFFERSON,29099,116688,37523,77046,114569,67.24855763775541,32.75144236224459,106238,31568,69036,100604,68.6215259830623,31.378474016937695,-2.000783756464075,4.375510244907965
MISSOURI,MO,JOHNSON,29101,23123,6974,15489,22463,68.95339001914259,31.04660998085741,21132,5930,13719,19649,69.82034709145503,30.179652908544963,-1.2416968812498874,2.872654218190096
MISSOURI,MO,KANSAS CITY,36000,136645,107660,26393,134053,19.688481421527307,80.3115185784727,128601,97735,24654,122389,20.143967186593567,79.85603281340643,-2.2611522390157623,0.5703836629733061
MISSOURI,MO,KNOX,29103,1854,340,1486,1826,81.38006571741512,18.619934282584886,1870,379,1416,1795,78.8857938718663,21.114206128133706,3.1618770923447226,-11.813240007282666
MISSOURI,MO,LACLEDE,29105,16793,2780,13762,16542,83.19429331398864,16.805706686011366,16051,2553,12881,15434,83.45859790073862,16.541402099261372,-0.3166894644747509,1.5978366595767346
MISSOURI,MO,LAFAYETTE,29107,17055,4472,12273,16745,73.29352045386683,26.706479546133174,15876,4053,10988,15041,73.05365334751679,26.946346652483214,0.32834375196679755,-0.8901655925514285
MISSOURI,MO,LAWRENCE,29109,17905,3214,14426,17640,81.78004535147392,18.219954648526077,16715,2901,13089,15990,81.85741088180113,18.142589118198874,-0.09451255481184306,0.4264304825687626
MISSOURI,MO,LEWIS,29111,4609,984,3553,4537,78.31165968701785,21.688340312982145,4456,934,3344,4278,78.16736792893876,21.832632071061244,0.1845933436191327,-0.6608995086321068
MISSOURI,MO,LINCOLN,29113,29018,6607,21848,28455,76.78088209453523,23.21911790546477,24962,5575,18159,23734,76.51049127833488,23.48950872166512,0.35340358123789883,-1.1511131177935674
MISSOURI,MO,LINN,29115,5726,1275,4363,5638,77.38559772969138,22.61440227030862,5587,1240,4088,5328,76.72672672672672,23.273273273273272,0.8587242426114639,-2.831019922415856
MISSOURI,MO,LIVINGSTON,29117,6758,1410,5267,6677,78.88273176576307,21.11726823423693,6421,1265,4879,6144,79.41080729166667,20.589192708333332,-0.6649920129435771,2.564818996957885
MISSOURI,MO,MACON,29121,7836,1662,6076,7738,78.52158180408374,21.47841819591626,7621,1548,5798,7346,78.92730737816498,21.072692621835014,-0.5140496838911379,1.9253618005173223
MISSOURI,MO,MADISON,29123,5676,1019,4584,5603,81.8133142959129,18.186685704087097,5321,1005,4102,5107,80.32112786371647,19.678872136283534,1.8577757457891808,-7.582682695748466
MISSOURI,MO,MARIES,29125,4771,814,3892,4706,82.70293242668933,17.297067573310667,4500,794,3561,4355,81.76808266360506,18.231917336394947,1.1432942202280305,-5.127544985178889
MISSOURI,MO,MARION,29127,13348,3202,9915,13117,75.58893039566973,24.411069604330258,12938,2994,9419,12413,75.88012567469589,24.119874325304117,-0.3837569804174157,1.2072835666504744
MISSOURI,MO,MCDONALD,29119,9053,1439,7465,8904,83.83872416891285,16.161275831087153,8242,1329,6599,7928,83.23662966700303,16.763370332996974,0.7233528127202682,-3.5917270211746177
MISSOURI,MO,MERCER,29129,1779,222,1541,1763,87.40782756664775,12.592172433352241,1745,216,1486,1702,87.3090481786134,12.690951821386603,0.11313763017124501,-0.7783449927522446
MISSOURI,MO,MILLER,29131,12382,2038,10176,12214,83.31422957262158,16.68577042737842,11416,1750,9285,11035,84.1413683733575,15.8586316266425,-0.9830346436317416,5.215700952069069
MISSOURI,MO,MISSISSIPPI,29133,4756,1178,3537,4715,75.01590668080594,24.984093319194063,5169,1458,3600,5058,71.17437722419929,28.82562277580071,5.397348886532338,-13.326787374153925
MISSOURI,MO,MONITEAU,29135,7157,1308,5744,7052,81.45207033465684,18.547929665343165,6830,1237,5347,6584,81.2120291616039,18.787970838396113,0.29557342124193475,-1.2776322420215092
MISSOURI,MO,MONROE,29137,4483,936,3477,4413,78.7899388171312,21.210061182868795,4156,853,3159,4012,78.73878364905285,21.26121635094716,0.06496819700232415,-0.24060320554559755
MISSOURI,MO,MONTGOMERY,29139,5772,1208,4465,5673,78.70615194782302,21.29384805217698,5429,1119,4127,5246,78.66946244757911,21.330537552420893,0.04663753774643009,-0.17200457397638091
MISSOURI,MO,MORGAN,29141,9487,1924,7442,9366,79.45761264146914,20.542387358530856,8821,1768,6760,8528,79.26829268292683,20.73170731707317,0.23883440923799792,-0.9131903882629189
MISSOURI,MO,NEW MADRID,29143,7250,1748,5447,7195,75.7053509381515,24.294649061848506,7357,1933,5270,7203,73.16395946133555,26.836040538664445,3.4735565099630383,-9.470068705382928
MISSOURI,MO,NEWTON,29145,28405,5818,22120,27938,79.17531677285417,20.824683227145822,26606,4990,20553,25543,80.4643150765376,19.535684923462398,-1.6019502588909607,6.598173080357861
MISSOURI,MO,NODAWAY,29147,9893,2853,6865,9718,70.64210742951225,29.357892570487756,9458,2529,6380,8909,71.6129756426086,28.3870243573914,-1.3557155032093093,3.420112657364749
MISSOURI,MO,OREGON,29149,4739,823,3847,4670,82.37687366167023,17.623126338329765,4668,865,3671,4536,80.93033509700176,19.069664902998237,1.787387341143054,-7.585547895186351
MISSOURI,MO,OSAGE,29151,7539,1037,6425,7462,86.10292146877512,13.897078531224873,7090,998,5856,6854,85.43915961482347,14.560840385176538,0.7768824704550203,-4.558540828641999
MISSOURI,MO,OZARK,29153,4864,752,4064,4816,84.38538205980066,15.614617940199336,4505,724,3639,4363,83.40591336236534,16.594086637634653,1.1743396336659329,-5.902516473633002
MISSOURI,MO,PEMISCOT,29155,5735,1560,4120,5680,72.53521126760563,27.464788732394368,6027,1947,3964,5911,67.06141092877685,32.93858907122314,8.162369778712652,-16.61819917966969
MISSOURI,MO,PERRY,29157,9447,1664,7657,9321,82.14783821478382,17.85216178521618,8740,1520,6908,8428,81.96487897484575,18.035121025154247,0.2232166291543214,-1.0144608382881781
MISSOURI,MO,PETTIS,29159,19097,4783,13854,18637,74.33599828298546,25.664001717014543,18111,4324,12810,17134,74.76362787440178,25.236372125598226,-0.5719754425704271,1.6944970905012013
MISSOURI,MO,PHELPS,29161,19568,5637,13480,19117,70.51315582988963,29.486844170110373,18553,4766,12709,17475,72.72675250357653,27.273247496423462,-3.043717198259399,8.116366318228874
MISSOURI,MO,PIKE,29163,7695,1717,5863,7580,77.34828496042216,22.651715039577837,7382,1806,5274,7080,74.49152542372882,25.508474576271187,3.835012802386961,-11.199256655475587
MISSOURI,MO,PLATTE,29165,57270,27179,28917,56096,51.54913006274957,48.45086993725043,48885,20057,25933,45990,56.38834529245488,43.61165470754512,-8.581942251731277,11.096151389248
MISSOURI,MO,POLK,29167,15064,2885,11850,14735,80.42076688157448,19.579233118425517,13763,2631,10438,13069,79.86839084857296,20.131609151427043,0.6916078152229277,-2.7438245440125186
MISSOURI,MO,PULASKI,29169,14414,3740,10329,14069,73.41673182173574,26.58326817826427,13488,2922,9876,12798,77.16830754805439,22.831692451945617,-4.8615498324651725,16.431439474820706
MISSOURI,MO,PUTNAM,29171,2361,361,1984,2345,84.60554371002132,15.394456289978677,2346,353,1936,2289,84.57841852337265,15.421581476627349,0.03207104971012509,-0.1758910828294824
MISSOURI,MO,RALLS,29173,5662,1205,4396,5601,78.485984645599,21.514015354401,5266,1138,3969,5107,77.71685921284511,22.283140787154885,0.9896506891091228,-3.451602447341029
MISSOURI,MO,RANDOLPH,29175,10744,2485,8018,10503,76.34009330667428,23.659906693325716,10309,2283,7529,9812,76.73257236037504,23.267427639624948,-0.5114895039064815,1.6868175536189023
MISSOURI,MO,RAY,29177,11649,3109,8345,11454,72.85664396717304,27.14335603282696,10869,3090,7104,10194,69.68805179517364,30.31194820482637,4.546822719786303,-10.453277864518428
MISSOURI,MO,REYNOLDS,29179,3298,529,2733,3262,83.78295524218271,16.21704475781729,3038,540,2406,2946,81.67006109979633,18.329938900203665,2.5871097853159997,-11.52701137679677
MISSOURI,MO,RIPLEY,29181,5717,833,4839,5672,85.31382228490833,14.686177715091679,5524,830,4522,5352,84.49177877428998,15.508221225710015,0.9729272155748259,-5.300695022685941
MISSOURI,MO,SALINE,29195,9519,2904,6451,9355,68.9577765900588,31.042223409941208,9274,2789,5977,8766,68.18389231120237,31.816107688797626,1.1349957484449558,-2.4323662920241462
MISSOURI,MO,SCHUYLER,29197,2003,373,1606,1979,81.15209701869631,18.84790298130369,1936,354,1505,1859,80.95750403442712,19.04249596557289,0.24036435731324968,-1.021888016261141
MISSOURI,MO,SCOTLAND,29199,1984,388,1560,1948,80.08213552361396,19.917864476386036,1968,365,1525,1890,80.68783068783068,19.312169312169313,-0.7506648264718807,3.136339343478367
MISSOURI,MO,SCOTT,29201,17719,3753,13769,17522,78.58121219038922,21.418787809610777,17256,3575,13168,16743,78.64779310756734,21.35220689243266,-0.08465706989012611,0.3118221807869137
MISSOURI,MO,SHANNON,29203,3906,706,3165,3871,81.76181865151123,18.238181348488762,3904,776,2966,3742,79.26242650988776,20.73757349011224,3.1533126749679896,-12.05248117777713
MISSOURI,MO,SHELBY,29205,3350,592,2700,3292,82.01701093560146,17.98298906439854,3255,606,2524,3130,80.63897763578275,19.361022364217252,1.7088923250525134,-7.117564733387072
MISSOURI,MO,ST. CHARLES,29183,222017,89530,128389,217919,58.91592747764077,41.08407252235923,201005,68626,121650,190276,63.93344404969623,36.06655595030377,-7.848031099584252,13.911826177606512
MISSOURI,MO,ST. CLAIR,29185,4974,988,3932,4920,79.91869918699187,20.08130081300813,4630,936,3501,4437,78.90466531440163,21.095334685598377,1.2851380441824878,-4.8069105691056935
MISSOURI,MO,ST. FRANCOIS,29187,28001,7044,20511,27555,74.43658138268917,25.563418617310834,24728,6250,17468,23718,73.64870562442027,26.35129437557973,1.0697754313385488,-2.989893957539469
MISSOURI,MO,ST. LOUIS CITY,29510,133867,110089,21474,131563,16.322218252852245,83.67778174714775,131191,104235,20832,125067,16.656672023795245,83.34332797620475,-2.0079267362964726,0.40129639536170547
MISSOURI,MO,ST. LOUIS COUNTY,29189,536446,328151,199493,527644,37.808257082426785,62.191742917573215,514858,286704,202434,489138,41.38586656526379,58.61413343473621,-8.644519928549188,6.103663524805825
MISSOURI,MO,STE. GENEVIEVE,29186,9484,2713,6630,9343,70.96221770309323,29.037782296906776,8469,2542,5496,8038,68.37521771584971,31.624782284150285,3.783534551940204,-8.180293429371876
MISSOURI,MO,STODDARD,29207,13426,1819,11484,13303,86.32639254303541,13.673607456964595,13291,1876,11079,12955,85.51910459282131,14.480895407178695,0.9439855036577072,-5.57484829159044
MISSOURI,MO,STONE,29209,18483,3506,14800,18306,80.84780946137879,19.152190538621216,16567,2887,13158,16045,82.0068557182923,17.993144281707696,-1.4133528797824368,6.441599304529766
MISSOURI,MO,SULLIVAN,29211,2471,478,1974,2452,80.50570962479608,19.494290375203914,2486,526,1884,2410,78.17427385892117,21.82572614107884,2.9823567918038973,-10.682053604103746
MISSOURI,MO,TANEY,29213,26288,5339,20508,25847,79.34383100553255,20.656168994467443,23515,4373,18276,22649,80.69230429599541,19.30769570400459,-1.6711299822550596,6.984123383419427
MISSOURI,MO,TEXAS,29215,11315,1716,9478,11194,84.67035912095766,15.329640879042344,10956,1728,8875,10603,83.70272564368575,16.29727435631425,1.1560358038888996,-5.937394536755802
MISSOURI,MO,VERNON,29217,9185,1903,7155,9058,78.99094722896886,21.009052771031133,8599,1707,6533,8240,79.28398058252426,20.716019417475728,-0.36959969895860034,1.4145253856453044
MISSOURI,MO,WARREN,29219,18375,4769,13222,17991,73.49230170640875,26.50769829359124,15784,3915,11111,15026,73.94516171968588,26.054838280314122,-0.6124268346235473,1.7381033357604103
MISSOURI,MO,WASHINGTON,29221,9976,1804,8047,9851,81.68713836158766,18.312861638412343,9282,1926,7048,8974,78.53799866280366,21.462001337196345,4.009701994450565,-14.673094318217872
MISSOURI,MO,WAYNE,29223,5878,845,4987,5832,85.51097393689986,14.489026063100138,5655,948,4658,5606,83.08954691402069,16.91045308597931,2.9142378467712726,-14.319113808291807
MISSOURI,MO,WEBSTER,29225,18779,3573,14880,18453,80.63729474882133,19.36270525117867,16743,3177,12840,16017,80.16482487357183,19.83517512642817,0.5893730523264251,-2.381979852650684
MISSOURI,MO,WORTH,29227,1107,215,877,1092,80.31135531135531,19.68864468864469,1046,195,808,1003,80.55832502492522,19.441674975074775,-0.3065725528596741,1.2703108856955136
MISSOURI,MO,WRIGHT,29229,8739,1168,7453,8621,86.4516877392414,13.548312260758612,8119,1170,6707,7877,85.146629427447,14.853370572553002,1.5327187001646703,-8.786277198294368
MONTANA,MT,BEAVERHEAD,30001,5661,1608,3923,5531,70.92749954800217,29.07250045199783,4849,1143,3353,4496,74.57740213523131,25.422597864768683,-4.894113340943096,14.356922162889107
MONTANA,MT,BIG HORN,30003,4784,2491,2207,4698,46.97743720732227,53.02256279267773,4237,2094,1853,3947,46.94704839118318,53.05295160881682,0.06472998235347305,-0.05728016107974243
MONTANA,MT,BLAINE,30005,3117,1589,1469,3058,48.03793328973185,51.96206671026815,2684,1202,1268,2470,51.336032388663966,48.663967611336034,-6.4245305791500895,6.777291825592613
MONTANA,MT,BROADWATER,30007,4097,835,3173,4008,79.16666666666667,20.833333333333332,3133,573,2348,2921,80.38343033207805,19.616569667921944,-1.5136996024985638,6.202734147760314
MONTANA,MT,CARBON,30009,7052,2421,4468,6889,64.85701843518653,35.14298156481347,5991,1828,3748,5576,67.21664275466284,32.78335724533716,-3.5104763088046664,7.197628668161871
MONTANA,MT,CARTER,30011,864,74,775,849,91.28386336866902,8.716136631330977,786,70,678,748,90.64171122994652,9.358288770053475,0.7084510321009319,-6.861854282348978
MONTANA,MT,CASCADE,30013,39885,15456,23315,38771,60.13515256248227,39.86484743751773,34571,12175,19632,31807,61.72226239507027,38.27773760492973,-2.571373392681664,4.146299995492941
MONTANA,MT,CHOUTEAU,30015,2965,991,1891,2882,65.61415683553088,34.385843164469115,2603,732,1679,2411,69.63915387805889,30.360846121941105,-5.7797902736956726,13.25719654308064
MONTANA,MT,CUSTER,30017,5860,1514,4205,5719,73.52684035670572,26.47315964329428,5185,1176,3657,4833,75.66728739913097,24.332712600869026,-2.8287614317859533,8.796582105477246
MONTANA,MT,DANIELS,30019,1014,195,799,994,80.38229376257546,19.617706237424546,962,168,730,898,81.29175946547885,18.70824053452116,-1.1187673989140334,4.861310721471668
MONTANA,MT,DAWSON,30021,4825,962,3758,4720,79.61864406779661,20.38135593220339,4374,787,3320,4107,80.83759435110787,19.162405648892136,-1.5079002450479884,6.36115478215924
MONTANA,MT,DEER LODGE,30023,4891,2562,2186,4748,46.04043807919124,53.95956192080876,4206,2058,1763,3821,46.139753991101806,53.860246008898194,-0.21525019819074176,0.18439557794474037
MONTANA,MT,FALLON,30025,1575,172,1375,1547,88.88170652876535,11.118293471234647,1484,154,1279,1433,89.2533147243545,10.746685275645499,-0.4163522629235694,3.457886651163955
MONTANA,MT,FERGUS,30027,6507,1496,4869,6365,76.49646504320502,23.503534956794972,5840,1202,4269,5471,78.02961067446536,21.970389325534637,-1.9648254271785737,6.978236063748167
MONTANA,MT,FLATHEAD,30029,59936,20274,38321,58595,65.39977813806638,34.60022186193361,46571,13293,30240,43533,69.46454413892909,30.53545586107091,-5.8515693887419395,13.31162704547928
MONTANA,MT,GALLATIN,30031,70979,37044,31696,68740,46.109979633401224,53.890020366598776,53819,24246,23802,48048,49.53796203796204,50.46203796203796,-6.919910031692211,6.793190570582275
MONTANA,MT,GARFIELD,30033,813,41,764,805,94.90683229813665,5.093167701863354,718,34,653,687,95.0509461426492,4.9490538573508,-0.15161747500783695,2.9119473876507262
MONTANA,MT,GLACIER,30035,5617,3610,1884,5494,34.2919548598471,65.70804514015289,5075,3121,1620,4741,34.17000632777895,65.82999367222105,0.35688764847845444,-0.18524767399396014
MONTANA,MT,GOLDEN VALLEY,30037,503,78,414,492,84.14634146341463,15.853658536585366,474,71,365,436,83.71559633027523,16.28440366972477,0.5145339124624115,-2.6451391274476155
MONTANA,MT,GRANITE,30039,2102,638,1419,2057,68.98395721925134,31.016042780748663,1777,472,1192,1664,71.63461538461539,28.365384615384617,-3.700247640239751,9.344693193147812
MONTANA,MT,HILL,30041,7182,2981,3957,6938,57.03372729893341,42.96627270106659,6445,2371,3478,5849,59.463156095058984,40.536843904941016,-4.085603515968517,5.9931375067644455
MONTANA,MT,JEFFERSON,30043,8151,2625,5345,7970,67.06398996235885,32.936010037641154,6714,1998,4177,6175,67.64372469635627,32.35627530364373,-0.857041413079751,1.7917227139309766
MONTANA,MT,JUDITH BASIN,30045,1344,275,1040,1315,79.08745247148289,20.91254752851711,1208,235,872,1107,78.77145438121048,21.22854561878952,0.4011581260683128,-1.4885527060917503
MONTANA,MT,LAKE,30047,16626,6916,9322,16238,57.40854785072053,42.59145214927947,13181,4776,7530,12306,61.18966357874208,38.81033642125792,-6.179337337188995,9.742548188658539
MONTANA,MT,LEWIS AND CLARK,30049,42265,19743,21409,41152,52.02420295489891,47.97579704510109,34478,14478,16895,31373,53.85203837694833,46.14796162305167,-3.394180567976113,3.9608150777701523
MONTANA,MT,LIBERTY,30051,1083,249,821,1070,76.72897196261682,23.27102803738318,961,206,698,904,77.21238938053098,22.787610619469028,-0.6260878879575826,2.12140459123491
MONTANA,MT,LINCOLN,30053,11747,2835,8672,11507,75.36282262970366,24.637177370296342,9330,2041,6729,8770,76.72748004561004,23.272519954389967,-1.7785771344180357,5.863814570063153
MONTANA,MT,MADISON,30057,6087,1771,4191,5962,70.29520295202953,29.70479704797048,4778,1180,3297,4477,73.64306455215547,26.35693544784454,-4.546065023889545,12.702013884545638
MONTANA,MT,MCCONE,30055,1128,155,956,1111,86.04860486048605,13.951395139513952,1060,154,862,1016,84.84251968503936,15.15748031496063,1.4215574689719679,-7.957029469180677
MONTANA,MT,MEAGHER,30059,1110,258,833,1091,76.35197066911091,23.64802933088909,977,193,729,922,79.06724511930585,20.932754880694144,-3.4341331180791967,12.97141473098311
MONTANA,MT,MINERAL,30061,2563,686,1828,2514,72.71280827366746,27.287191726332537,2012,519,1330,1849,71.93077339102217,28.069226608977825,1.0872048857226702,-2.786093445108162
MONTANA,MT,MISSOULA,30063,71495,43357,26347,69704,37.798404682658095,62.201595317341905,59203,31543,22250,53793,41.36225902998532,58.63774097001468,-8.616198512619022,6.077748372246572
MONTANA,MT,MUSSELSHELL,30065,2881,413,2423,2836,85.43723554301833,14.562764456981665,2441,332,1967,2299,85.55893866898651,14.441061331013485,-0.14224478220683512,0.8427574897615919
MONTANA,MT,PARK,30067,11566,5280,6025,11305,53.29500221141088,46.70499778858912,9359,3595,4980,8575,58.075801749271136,41.924198250728864,-8.23199920424732,11.403437006161798
MONTANA,MT,PETROLEUM,30069,348,39,298,337,88.4272997032641,11.572700296735905,322,30,278,308,90.25974025974025,9.74025974025974,-2.0301859402685474,18.81305637982196
MONTANA,MT,PHILLIPS,30071,2382,416,1936,2352,82.31292517006803,17.687074829931973,2171,318,1723,2041,84.41940225379716,15.58059774620284,-2.495252308700613,13.519873358148304
MONTANA,MT,PONDERA,30073,2995,903,2031,2934,69.22290388548058,30.777096114519427,2723,738,1799,2537,70.9105242412298,29.089475758770202,-2.379929317696372,5.80148081644416
MONTANA,MT,POWDER RIVER,30075,1136,154,970,1124,86.29893238434164,13.701067615658364,1053,127,884,1011,87.4381800197824,12.561819980217606,-1.3029178274101882,9.069128814414217
MONTANA,MT,POWELL,30077,3179,752,2355,3107,75.7965883488896,24.203411651110397,2794,551,2029,2580,78.64341085271317,21.356589147286822,-3.619912301559791,13.329949291950683
MONTANA,MT,PRAIRIE,30079,744,126,603,729,82.71604938271605,17.28395061728395,689,100,556,656,84.7560975609756,15.24390243902439,-2.4069633182342898,13.382716049382704
MONTANA,MT,RAVALLI,30081,28507,8763,19114,27877,68.56548409082757,31.434515909172436,22556,6223,14810,21033,70.4131602719536,29.586839728046403,-2.6240495015276033,6.244925778181565
MONTANA,MT,RICHLAND,30083,5798,875,4800,5675,84.58149779735683,15.418502202643172,4871,671,3908,4579,85.346145446604055,14.653854553395938,-0.8959369462392619,5.218064956636481
MONTANA,MT,ROOSEVELT,30085,4017,1910,1996,3906,51.10087045570916,48.89912954429084,3652,1560,1797,3357,53.52993744414656,46.47006255585344,-4.537772888249492,5.2271653078104885
MONTANA,MT,ROSEBUD,30087,3773,1199,2486,3685,67.46268656716418,32.53731343283582,3453,987,2253,3240,69.53703703703704,30.462962962962962,-2.9830872269809405,6.809417955813646
MONTANA,MT,SANDERS,30089,7622,1820,5660,7480,75.66844919786097,24.331550802139038,5953,1218,4286,5504,77.87063953488372,22.129360465116278,-2.8280111094197924,9.951441391603666
MONTANA,MT,SHERIDAN,30091,2030,574,1403,1977,70.96611026808296,29.033889731917046,1835,477,1241,1718,72.23515715948777,27.764842840512223,-1.7568272034113375,4.570697189588024
MONTANA,MT,SILVER BOW,30093,18658,10392,7745,18137,42.70276230909191,57.29723769090809,16452,8619,6376,14995,42.52084028009337,57.47915971990663,0.42784203651711206,-0.31650084984721216
MONTANA,MT,STILLWATER,30095,5724,1156,4462,5618,79.42328230687077,20.57671769312923,4873,908,3661,4569,80.12694243817027,19.87305756182972,-0.8781816825750965,3.540774383157985
MONTANA,MT,SWEET GRASS,30097,2446,549,1840,2389,77.01967350355797,22.980326496442025,2107,402,1595,1997,79.8698047070606,20.13019529293941,-3.568471481752189,14.15848759550926
MONTANA,MT,TETON,30099,3679,1007,2608,3615,72.14384508990318,27.85615491009682,3188,808,2170,2978,72.86769644056413,27.13230355943586,-0.9933775678655832,2.667858072114271
MONTANA,MT,TOOLE,30101,2119,467,1596,2063,77.36306349975763,22.636936500242367,2037,402,1497,1899,78.83096366508688,21.169036334913113,-1.862085780868572,6.934185109353863
MONTANA,MT,TREASURE,30103,460,78,373,451,82.70509977827051,17.29490022172949,443,59,351,410,85.60975609756098,14.390243902439025,-3.3929033929033903,20.18489984591678
MONTANA,MT,VALLEY,30105,4261,1030,3135,4165,75.27010804321729,24.729891956782712,3894,886,2698,3584,75.27901785714286,24.720982142857142,-0.011835720203579037,0.03604150463796252
MONTANA,MT,WHEATLAND,30107,1068,225,823,1048,78.53053435114504,21.46946564885496,946,179,702,881,79.6821793416572,20.317820658342793,-1.4452980578934738,5.668152160006823
MONTANA,MT,WIBAUX,30109,598,77,516,593,87.01517706576729,12.984822934232715,541,55,463,518,89.38223938223938,10.617760617760618,-2.6482468249082958,22.293423271500835
MONTANA,MT,YELLOWSTONE,30111,83821,30679,50772,81451,62.33440964506268,37.66559035493732,69108,22171,40920,63091,64.85869616902569,35.14130383097431,-3.8919785210984936,7.183246632238083
NEBRASKA,NE,ADAMS,31001,14602,4213,10085,14298,70.5343404671982,29.46565953280179,13513,3302,9287,12589,73.77075224402256,26.22924775597744,-4.387120475766315,12.338942416245224
NEBRASKA,NE,ANTELOPE,31003,3583,452,3093,3545,87.24964739069111,12.750352609308885,3281,383,2732,3115,87.70465489566614,12.295345104333869,-0.5187951603210839,3.7006485065200545
NEBRASKA,NE,ARTHUR,31005,284,21,260,281,92.52669039145907,7.473309608540926,273,17,244,261,93.48659003831418,6.513409961685824,-1.0267779009392686,14.73728281348128
NEBRASKA,NE,BANNER,31007,410,43,362,405,89.38271604938272,10.617283950617283,402,19,357,376,94.94680851063829,5.053191489361702,-5.860220631462454,110.11046133853148
NEBRASKA,NE,BLAINE,31009,317,35,280,315,88.88888888888889,11.11111111111111,317,30,276,306,90.19607843137256,9.803921568627452,-1.449275362318847,13.33333333333333
NEBRASKA,NE,BOONE,31011,3217,499,2653,3152,84.16878172588832,15.831218274111675,2905,414,2299,2713,84.74014006634722,15.259859933652782,-0.6742475761918221,3.7441912503984875
NEBRASKA,NE,BOX BUTTE,31013,5181,1051,4002,5053,79.2004749653671,20.799525034632893,4924,965,3617,4582,78.9393278044522,21.060672195547795,0.3308200971280373,-1.2399754314114886
NEBRASKA,NE,BOYD,31015,1153,135,1010,1145,88.20960698689956,11.790393013100436,1156,128,983,1111,88.47884788478848,11.521152115211521,-0.3042997330158559,2.336926855895194
NEBRASKA,NE,BROWN,31017,1679,191,1470,1661,88.50090307043949,11.499096929560507,1597,153,1385,1538,90.0520156046814,9.947984395318596,-1.722462871959607,15.592229265778169
NEBRASKA,NE,BUFFALO,31019,23589,6350,16640,22990,72.37929534580252,27.62070465419748,21129,4763,14569,19332,75.36209393751294,24.63790606248707,-3.9579560968457606,12.10654259394197
NEBRASKA,NE,BURT,31021,3731,1063,2580,3643,70.82075212736756,29.179247872632445,3558,930,2367,3297,71.79253867151957,28.207461328480438,-1.3536038175197218,3.4451400387840447
NEBRASKA,NE,BUTLER,31023,4498,873,3542,4415,80.22650056625142,19.773499433748583,3981,691,3079,3770,81.6710875331565,18.3289124668435,-1.768786250481369,7.881465796283882
NEBRASKA,NE,CASS,31025,15284,4737,10121,14858,68.1181854892987,31.881814510701307,12933,3484,8452,11936,70.81099195710456,29.18900804289544,-3.802808565988025,9.22541274389519
NEBRASKA,NE,CEDAR,31027,4996,725,4174,4899,85.20106144111043,14.798938558889569,4420,571,3532,4103,86.08335364367537,13.916646356324641,-1.0249277766489095,6.339833462563749
NEBRASKA,NE,CHASE,31029,1993,226,1740,1966,88.50457782299084,11.495422177009155,1898,171,1648,1819,90.59923034634414,9.400769653655855,-2.3119981431915404,22.28171309929621
NEBRASKA,NE,CHERRY,31031,3265,373,2844,3217,88.40534659620765,11.594653403792353,3118,317,2623,2940,89.21768707482993,10.782312925170068,-0.9105150618183289,7.534009486276094
NEBRASKA,NE,CHEYENNE,31033,4765,855,3813,4668,81.68380462724936,18.31619537275064,4711,711,3665,4376,83.75228519195612,16.247714808043877,-2.4697601503838484,12.730901478420243
NEBRASKA,NE,CLAY,31035,3558,632,2848,3480,81.83908045977012,18.160919540229884,3065,477,2422,2899,83.54605036219387,16.45394963780614,-2.0431485330827615,10.374225884961085
NEBRASKA,NE,COLFAX,31037,3717,1025,2636,3661,72.00218519530183,27.99781480469817,3214,859,2171,3030,71.65016501650165,28.34983498349835,0.4913040726690854,-1.241700979935445
NEBRASKA,NE,CUMING,31039,4451,870,3507,4377,80.12337217272105,19.87662782727896,4074,719,3122,3841,81.28091642801354,18.719083571986463,-1.4241279579046973,6.183765625283
NEBRASKA,NE,CUSTER,31041,5993,786,5090,5876,86.62355343771273,13.37644656228727,5652,641,4695,5336,87.9872563718141,12.012743628185907,-1.549886870365258,11.35213550134926
NEBRASKA,NE,DAKOTA,31043,6794,2744,3926,6670,58.86056971514243,41.13943028485757,6279,2314,3616,5930,60.97807757166948,39.02192242833052,-3.4725723421475063,5.426457039414601
NEBRASKA,NE,DAWES,31045,4121,1082,2931,4013,73.03762770994268,26.962372290057314,3676,801,2632,3433,76.66763763472181,23.332362365278183,-4.734735589577033,15.55783279871006
NEBRASKA,NE,DAWSON,31047,9178,2497,6524,9021,72.32014189114288,27.67985810885711,8635,2136,5984,8120,73.69458128078817,26.305418719211822,-1.8650481022593146,5.2249287658800325
NEBRASKA,NE,DEUEL,31049,1032,141,871,1012,86.06719367588933,13.932806324110672,984,120,809,929,87.08288482238967,12.917115177610334,-1.1663499074151096,7.863142292490122
NEBRASKA,NE,DIXON,31051,3083,651,2335,2986,78.19825853985265,21.801741460147355,2782,556,2041,2597,78.59068155564113,21.409318444358874,-0.4993251210204219,1.8329542661918774
NEBRASKA,NE,DODGE,31053,16876,5544,10984,16528,66.4569215876089,33.5430784123911,15529,4544,9933,14477,68.6122815500449,31.387718449955102,-3.141361741285198,6.866889563421186
NEBRASKA,NE,DOUGLAS,31055,274951,150350,119159,269509,44.21336578741341,55.78663421258659,240433,113798,108077,221875,48.71076056338028,51.28923943661972,-9.232856814286572,8.76869071440316
NEBRASKA,NE,DUNDY,31057,999,105,883,988,89.37246963562752,10.62753036437247,953,89,823,912,90.24122807017544,9.758771929824562,-0.9627067950275792,8.902333621434755
NEBRASKA,NE,FILLMORE,31059,3134,693,2359,3052,77.29357798165138,22.706422018348626,2941,613,2130,2743,77.65220561429092,22.34779438570908,-0.46183830813627536,1.6047562746007715
NEBRASKA,NE,FRANKLIN,31061,1724,276,1437,1713,83.88791593695271,16.112084063047284,1673,250,1347,1597,84.34564809016906,15.654351909830932,-0.5426861534421068,2.923992994746061
NEBRASKA,NE,FRONTIER,31063,1440,189,1229,1418,86.67136812411847,13.328631875881523,1328,161,1110,1271,87.33280881195908,12.667191188040913,-0.7573793822030717,5.221683939412514
NEBRASKA,NE,FURNAS,31065,2601,399,2163,2562,84.42622950819673,15.573770491803279,2340,304,1921,2225,86.33707865168539,13.662921348314606,-2.213242761198475,13.985655737704917
NEBRASKA,NE,GAGE,31067,11068,3385,7445,10830,68.74422899353647,31.255771006463526,10048,2935,6380,9315,68.49168008588299,31.508319914117017,0.368729322067729,-0.8015308602358662
NEBRASKA,NE,GARDEN,31069,1195,161,1016,1177,86.32115548003398,13.678844519966015,1075,153,869,1022,85.0293542074364,14.970645792563602,1.5192415426866779,-8.62889477512898
NEBRASKA,NE,GARFIELD,31071,1075,133,933,1066,87.5234521575985,12.476547842401501,980,121,821,942,87.15498938428875,12.845010615711253,0.4227672746136113,-2.8685283674197204
NEBRASKA,NE,GOSPER,31073,1118,215,893,1108,80.5956678700361,19.404332129963898,1010,166,794,960,82.70833333333333,17.291666666666668,-2.5543562276641563,12.217824366056274
NEBRASKA,NE,GRANT,31075,402,20,375,395,94.9367088607595,5.063291139240507,405,20,367,387,94.83204134366925,5.167958656330749,0.11037146897527883,-2.025316455696191
NEBRASKA,NE,GREELEY,31077,1258,229,1016,1245,81.60642570281125,18.393574297188756,1175,210,912,1122,81.28342245989305,18.71657754010695,0.3973789896427826,-1.725760183591496
NEBRASKA,NE,HALL,31079,24374,7681,16189,23870,67.82153330540427,32.17846669459573,22060,6282,14408,20690,69.63750604156597,30.362493958434026,-2.607750965518152,5.980973561156566
NEBRASKA,NE,HAMILTON,31081,5533,1118,4309,5427,79.39929979730975,20.600700202690252,5004,878,3783,4661,81.1628405921476,18.837159407852393,-2.1728426235102405,9.362031486035605
NEBRASKA,NE,HARLAN,31083,1928,282,1615,1897,85.13442277279916,14.865577227200843,1832,254,1496,1750,85.48571428571428,14.514285714285714,-0.41093592754108954,2.420315541738094
NEBRASKA,NE,HAYES,31085,534,34,494,528,93.56060606060606,6.4393939393939394,514,30,472,502,94.02390438247012,5.9760956175298805,-0.49274524910117856,7.752525252525255
NEBRASKA,NE,HITCHCOCK,31087,1469,175,1264,1439,87.83877692842252,12.161223071577485,1468,161,1232,1393,88.44221105527639,11.557788944723619,-0.6822919957040874,5.2210170106052
NEBRASKA,NE,HOLT,31089,5537,686,4769,5455,87.4243813015582,12.575618698441797,5118,531,4354,4885,89.12998976458546,10.870010235414535,-1.91361904958387,15.690955446117094
NEBRASKA,NE,HOOKER,31091,442,59,376,435,86.4367816091954,13.563218390804598,417,40,355,395,89.87341772151899,10.126582278481013,-3.8238627165290584,33.9367816091954
NEBRASKA,NE,HOWARD,31093,3501,648,2786,3434,81.12987769365172,18.870122306348282,2994,544,2284,2828,80.76379066478076,19.236209335219236,0.4532811373235912,-1.903114186851207
NEBRASKA,NE,JEFFERSON,31095,3716,1016,2616,3632,72.02643171806167,27.973568281938327,3494,837,2399,3236,74.13473423980223,25.865265760197776,-2.8438795166121023,8.151095532081754
NEBRASKA,NE,JOHNSON,31097,2229,647,1518,2165,70.11547344110855,29.884526558891455,2089,563,1355,1918,70.64650677789363,29.353493222106362,-0.7516767084529863,1.8090975842874002
NEBRASKA,NE,KEARNEY,31099,3604,701,2822,3523,80.10218563724099,19.89781436275901,3296,550,2531,3081,82.14865303472898,17.851346965271016,-2.4911758402451523,11.463938275746388
NEBRASKA,NE,KEITH,31101,4364,763,3544,4307,82.28465289064314,17.715347109356863,4034,571,3235,3806,84.9973725696269,15.002627430373096,-3.1915335697719316,18.081630644855018
NEBRASKA,NE,KEYA PAHA,31103,529,49,476,525,90.66666666666667,9.333333333333334,479,40,460,500,92,8,-1.449275362318836,16.666666666666675
NEBRASKA,NE,KIMBALL,31105,1874,268,1563,1831,85.36318951392681,14.636810486073184,1677,230,1330,1560,85.25641025641026,14.743589743589743,0.1252448434028608,-0.7242419205470974
NEBRASKA,NE,KNOX,31107,4697,905,3721,4626,80.43666234327713,19.563337656722872,4115,720,3188,3908,81.57625383828045,18.42374616171955,-1.3969647310141053,6.185449392323594
NEBRASKA,NE,LANCASTER,31109,156091,82293,70092,152385,45.99665321389901,54.00334678610099,136223,61898,61588,123486,49.87447969810343,50.12552030189657,-7.775171806658232,7.736231885173472
NEBRASKA,NE,LINCOLN,31111,17107,3692,13071,16763,77.97530275010439,22.024697249895603,16131,2913,12164,15077,80.67918020826424,19.320819791735758,-3.3513943140970115,13.994631114547197
NEBRASKA,NE,LOGAN,31113,450,38,407,445,91.46067415730337,8.539325842696629,453,32,400,432,92.5925925925926,7.407407407407407,-1.222471910112355,15.280898876404493
NEBRASKA,NE,LOUP,31115,454,75,370,445,83.14606741573034,16.853932584269664,385,48,323,371,87.06199460916442,12.93800539083558,-4.4978606463283,30.266853932584283
NEBRASKA,NE,MADISON,31119,15765,3478,11940,15418,77.4419509664029,22.558049033597094,14343,2711,10628,13339,79.67613764150236,20.32386235849764,-2.8040850639021286,10.99292366623077
NEBRASKA,NE,MCPHERSON,31117,302,17,275,292,94.17808219178082,5.821917808219178,287,14,257,271,94.8339483394834,5.166051660516605,-0.6915942646980588,12.695694716242656
NEBRASKA,NE,MERRICK,31121,4257,743,3419,4162,82.14800576645844,17.851994233541568,3788,602,2926,3528,82.93650793650794,17.063492063492063,-0.9507298892462823,4.620989461685476
NEBRASKA,NE,MORRILL,31123,2557,386,2113,2499,84.55382152861145,15.446178471388555,2209,284,1802,2086,86.38542665388303,13.61457334611697,-2.120270971873761,13.45326863139622
NEBRASKA,NE,"NANCE",31125,1828,359,1437,1796,80.01113585746103,19.988864142538976,1621,281,1261,1542,81.7769130998703,18.2230869001297,-2.1592613067367927,9.689781166530608
NEBRASKA,NE,NEMAHA,31127,3423,921,2428,3349,72.49925350851001,27.50074649149,3161,785,2116,2901,72.9403653912444,27.0596346087556,-0.6047568864898212,1.6301472252388427
NEBRASKA,NE,NUCKOLLS,31129,2303,409,1857,2266,81.95057369814651,18.049426301853487,2205,353,1726,2079,83.02068302068302,16.97931697931698,-1.288967138791075,6.30242855964136
NEBRASKA,NE,OTOE,31131,8315,2490,5649,8139,69.40656100258018,30.59343899741983,7457,2025,4860,6885,70.58823529411765,29.41176470588235,-1.6740385796780943,4.01769259122744
NEBRASKA,NE,PAWNEE,31133,1429,322,1071,1393,76.88442211055276,23.115577889447238,1327,279,974,1253,77.73343974461292,22.26656025538707,-1.0922167304695862,3.8129716683777515
NEBRASKA,NE,PERKINS,31135,1544,199,1321,1520,86.90789473684211,13.092105263157896,1455,161,1217,1378,88.31640058055153,11.683599419448477,-1.594840634865724,12.055410264792421
NEBRASKA,NE,PHELPS,31137,5009,752,4157,4909,84.68119779995926,15.318802200040741,4695,572,3849,4421,87.0617507351278,12.938249264872201,-2.7343269748974053,18.39934357758761
NEBRASKA,NE,PIERCE,31139,4006,480,3462,3942,87.8234398782344,12.1765601217656,3630,382,3052,3434,88.87594641817122,11.124053581828772,-1.1842422864164703,9.461537848542068
NEBRASKA,NE,PLATTE,31141,15673,3260,12186,15446,78.89421209374595,21.105787906254047,14433,2646,10965,13611,80.55984130482697,19.44015869517302,-2.0675676417714395,8.56798155405285
NEBRASKA,NE,POLK,31143,2879,530,2291,2821,81.21233605104572,18.787663948954272,2582,413,2028,2441,83.0807046292503,16.919295370749694,-2.2488598123261205,11.042827359315677
NEBRASKA,NE,RED WILLOW,31145,5452,811,4525,5336,84.80134932533733,15.19865067466267,5170,645,4258,4903,86.84478890475219,13.155211095247807,-2.3529789238776577,15.533308926931898
NEBRASKA,NE,RICHARDSON,31147,4126,996,3073,4069,75.52224133693782,24.47775866306218,3805,818,2769,3587,77.19542793420686,22.804572065793142,-2.1674685173001196,7.337066411251869
NEBRASKA,NE,ROCK,31149,841,84,744,828,89.85507246376811,10.144927536231885,798,70,687,757,90.75297225891677,9.247027741083222,-0.9893888572453213,9.710144927536257
NEBRASKA,NE,SALINE,31151,5770,1986,3631,5617,64.64304789033292,35.356952109667084,5136,1733,3004,4737,63.4156639223137,36.5843360776863,1.9354586739371182,-3.354943944897304
NEBRASKA,NE,SARPY,31153,95673,41206,51979,93185,55.78043676557386,44.21956323442614,80580,28033,45143,73176,61.690991581939436,38.309008418060564,-9.580904220861864,15.42862908865863
NEBRASKA,NE,SAUNDERS,31155,12735,3331,9108,12439,73.221320041804,26.778679958195998,10860,2523,7555,10078,74.96527088708076,25.03472911291923,-2.326345019020404,6.966126285651719
NEBRASKA,NE,SCOTTS BLUFF,31157,15469,4196,10952,15148,72.29997359387377,27.70002640612622,14317,3207,10076,13283,75.85635775050817,24.143642249491833,-4.688313889695772,14.730106252751662
NEBRASKA,NE,SEWARD,31159,9142,2438,6490,8928,72.69265232974911,27.307347670250895,7922,1875,5454,7329,74.4167007777323,25.583299222267705,-2.3167493720698262,6.738960573476693
NEBRASKA,NE,SHERIDAN,31161,2672,340,2292,2632,87.08206686930092,12.917933130699089,2608,287,2211,2498,88.51080864691754,11.489191353082466,-1.6142003439558184,12.435529479046426
NEBRASKA,NE,SHERMAN,31163,1698,343,1322,1665,79.3993993993994,20.6006006006006,1573,340,1150,1490,77.18120805369128,22.818791946308725,2.8740044392218334,-9.720897367956194
NEBRASKA,NE,SIOUX,31165,729,72,642,714,89.91596638655462,10.084033613445378,736,81,616,697,88.37876614060258,11.621233859397417,1.7393320964749437,-13.227513227513231
NEBRASKA,NE,STANTON,31167,3161,532,2561,3093,82.79987067571936,17.200129324280635,2801,417,2187,2604,83.98617511520737,16.013824884792626,-1.4124996618320895,7.408001823565402
NEBRASKA,NE,THAYER,31169,2980,624,2308,2932,78.71759890859481,21.282401091405184,2690,499,2051,2550,80.43137254901961,19.568627450980394,-2.1307278318299594,8.75776108834312
NEBRASKA,NE,THOMAS,31171,427,45,377,422,89.33649289099526,10.663507109004739,393,30,344,374,91.97860962566845,8.0213903743315509,-2.872533891766782,32.938388625592395
NEBRASKA,NE,THURSTON,31173,2325,1122,1180,2302,51.25977410947002,48.74022589052998,2088,919,1043,1962,53.160040774719675,46.839959225280325,-3.5746147624351132,4.0569349262457255
NEBRASKA,NE,VALLEY,31175,2340,412,1901,2313,82.18763510592305,17.812364894076957,2205,339,1780,2119,84.00188768286928,15.998112317130722,-2.159775960982624,11.340416550292254
NEBRASKA,NE,WASHINGTON,31177,12413,3554,8583,12137,70.71764027354371,29.282359726456292,10832,2623,7424,10047,73.89270428983777,26.107295710162237,-4.2968572429561425,12.161596710524725
NEBRASKA,NE,WAYNE,31179,4200,1022,3055,4077,74.93254844248222,25.06745155751778,3776,835,2693,3528,76.33219954648526,23.66780045351474,-1.8336313014937766,5.9137354430212286
NEBRASKA,NE,WEBSTER,31181,1876,335,1511,1846,81.85265438786566,18.147345612134345,1708,306,1330,1636,81.2958435207824,18.704156479217605,0.6849192319911435,-2.9769365312033114
NEBRASKA,NE,WHEELER,31183,502,59,438,497,88.12877263581488,11.87122736418511,465,62,377,439,85.87699316628702,14.123006833712983,2.6220986395828483,-15.944051405205428
NEBRASKA,NE,YORK,31185,7143,1630,5337,6967,76.60399023970145,23.39600976029855,6381,1186,4700,5886,79.8504926945294,20.149507305470607,-4.0657262657696425,16.11206867547832
NEVADA,NV,CARSON CITY,32510,29739,12735,16113,28848,55.85482529118136,44.14517470881864,25016,9610,13125,22735,57.73037167363096,42.26962832636904,-3.248803581332693,4.4371016654517925
NEVADA,NV,CHURCHILL,32001,12881,3048,9367,12415,75.4490535642368,24.55094643576319,10938,2210,7830,10040,77.98804780876495,22.01195219123506,-3.2556196954102834,11.534616386906071
NEVADA,NV,CLARK,32003,972308,521777,430809,952586,45.225208012714866,54.774791987285134,767156,402227,320057,722284,44.31179425267623,55.68820574732377,2.0613332758094627,-1.6402283890831426
NEVADA,NV,DOUGLAS,32005,34117,11570,21623,33193,65.14325309553219,34.85674690446781,27885,8454,17415,25869,67.31995825118868,32.68004174881132,-3.2333727058098116,6.660655981982222
NEVADA,NV,ELKO,32007,21957,4555,16734,21289,78.60397388322608,21.39602611677392,18559,3401,13551,16952,79.93747050495517,20.06252949504483,-1.6681746536456044,6.646702361526469
NEVADA,NV,ESMERALDA,32009,480,72,395,467,84.58244111349036,15.417558886509635,423,65,329,394,83.50253807106598,16.497461928934012,1.2932577468547146,-6.54587382638776
NEVADA,NV,EUREKA,32011,1008,104,887,991,89.50554994954591,10.494450050454088,854,74,723,797,90.71518193224593,9.284818067754077,-1.3334394055489862,13.028063381242006
NEVADA,NV,HUMBOLDT,32013,7771,1689,5877,7566,77.67644726407613,22.32355273592387,6433,1386,4521,5907,76.53631284916202,23.463687150837988,1.4896646735009345,-4.859144292133988
NEVADA,NV,LANDER,32015,2765,496,2198,2694,81.58871566443949,18.411284335560506,2413,403,1828,2231,81.9363514119229,18.063648588077097,-0.42427535702159735,1.924504597110377
NEVADA,NV,LINCOLN,32017,2446,330,2067,2397,86.23279098873591,13.76720901126408,2132,285,1671,1956,85.42944785276073,14.570552147239264,0.9403585720930252,-5.513470785850727
NEVADA,NV,LYON,32019,30229,8472,20906,29378,71.16209408400844,28.83790591599156,23762,6146,16005,22151,72.25407430815764,27.745925691842356,-1.5113060884179186,3.9356417092627716
NEVADA,NV,MINERAL,32021,2327,824,1420,2244,63.27985739750446,36.72014260249554,1997,637,1179,1816,64.92290748898678,35.07709251101321,-2.530770963640283,4.684111406800495
NEVADA,NV,NYE,32023,25376,7287,17527,24814,70.63351333924398,29.366486660756024,19595,5094,13324,18418,72.34227386252579,27.65772613747421,-2.362049783683906,6.178239363526594
NEVADA,NV,PERSHING,32027,2320,547,1731,2278,75.98770851624232,24.012291483757682,1982,430,1403,1833,76.54118930714675,23.458810692853245,-0.7231149606042875,2.3593727668089093
NEVADA,NV,STOREY,32029,2868,900,1901,2801,67.86861835058907,32.131381649410926,2558,752,1616,2368,68.24324324324324,31.756756756756758,-0.5489552882457116,1.1796698747407852
NEVADA,NV,WASHOE,32031,251956,128052,116653,244705,47.67086900553728,52.32913099446272,209909,97379,94758,192137,49.31793459874985,50.68206540125015,-3.3396889115756334,3.2497996681325914
NEVADA,NV,WHITE PINE,32033,4363,856,3400,4256,79.88721804511279,20.112781954887218,3773,707,2723,3430,79.38775510204081,20.612244897959183,0.6291435529698353,-2.423137050547153
NEW HAMPSHIRE,NH,BELKNAP,33001,38391,16894,20899,37793,55.29860026989125,44.70139973010875,35045,13517,19315,32832,58.82980019493177,41.17019980506823,-6.002399996838226,8.577077453497829
NEW HAMPSHIRE,NH,CARROLL,33003,33221,16649,16150,32799,49.239306076404766,50.760693923595234,29616,12987,14635,27622,52.98312938961697,47.01687061038303,-7.066066795869319,7.962723304654462
NEW HAMPSHIRE,NH,CHESHIRE,33005,44220,25522,17898,43420,41.22063565177338,58.77936434822662,41895,22064,16876,38940,43.33846944016435,56.66153055983565,-4.886729540172108,3.7376925181265674
NEW HAMPSHIRE,NH,COOS,33007,16515,7640,8617,16257,53.00485944516208,46.99514055483792,15627,6563,7952,14515,54.784705477092665,45.215294522907335,-3.248800949883346,3.936380489634672
NEW HAMPSHIRE,NH,GRAFTON,33009,53966,33180,19905,53085,37.49646792879344,62.50353207120656,51191,28510,19010,47520,40.004208754208754,59.995791245791246,-6.268692478891936,4.179861242502136
NEW HAMPSHIRE,NH,HILLSBOROUGH,33011,230941,122344,104625,226969,46.096603500918626,53.903396499081374,214157,99589,100013,199602,50.10621136060761,49.89378863939239,-8.00221719186146,8.036286618096788
NEW HAMPSHIRE,NH,MERRIMACK,33013,89805,48533,39711,88244,45.00135986582657,54.99864013417343,83648,40198,37674,77872,48.37939182247791,51.62060817752209,-6.982377887358737,6.543960011153627
NEW HAMPSHIRE,NH,ROCKINGHAM,33015,198798,100064,95858,195922,48.92661365237186,51.07338634762814,181434,79994,90447,170441,53.06645701445075,46.93354298554925,-7.80124318635319,8.82064957966957
NEW HAMPSHIRE,NH,STRAFFORD,33017,73596,41721,30489,72210,42.22268383880349,57.77731616119651,69000,34894,29072,63966,45.44914485820592,54.55085514179408,-7.099057703876433,5.914592926207818
NEW HAMPSHIRE,NH,SULLIVAN,33019,24380,12390,11508,23898,48.154657293497365,51.845342706502635,22683,10210,10796,21006,51.39483956964677,48.60516043035323,-6.3044895232303055,6.666333877844699
NEW JERSEY,NJ,ATLANTIC,34001,140031,73808,64438,138246,46.61111352227189,53.38888647772811,117291,60924,52690,113614,46.37632686112627,53.62367313887373,0.5062640295957266,-0.4378414371905781
NEW JERSEY,NJ,BERGEN,34003,495849,285967,204417,490384,41.68508760481582,58.31491239518418,419296,231211,175529,406740,43.15508678762846,56.84491321237154,-3.4063172901185212,2.5859819282699092
NEW JERSEY,NJ,BURLINGTON,34005,261497,154595,103345,257940,40.06551911297201,59.93448088702799,218943,121725,89272,210997,42.309606297719874,57.690393702280126,-5.303966122863213,3.88988017022176
NEW JERSEY,NJ,CAMDEN,34007,264616,175065,86207,261272,32.99511620074099,67.004883799259,226592,146717,72631,219348,33.11222349873261,66.8877765012674,-0.35366787735080507,0.17508026745274297
NEW JERSEY,NJ,CAPE MAY,34009,57714,23941,33158,57099,58.07106954587646,41.92893045412354,48722,18750,28446,47196,60.27205695397915,39.72794304602085,-3.6517542611549825,5.540149424683438
NEW JERSEY,NJ,CUMBERLAND,34011,62408,32742,28952,61694,46.92838849807112,53.07161150192888,54004,27771,24453,52224,46.82329963235294,53.17670036764706,0.22443712114121883,-0.19762201300875804
NEW JERSEY,NJ,ESSEX,34013,345311,266820,75475,342295,22.04969397741714,77.95030602258286,310934,240837,63176,304013,20.780690299427985,79.21930970057201,6.1066483341224,-1.6018868162139266
NEW JERSEY,NJ,GLOUCESTER,34015,172654,86702,83340,170042,49.011420707825124,50.988579292174876,139542,66870,67544,134414,50.250717931167884,49.749282068832116,-2.4662278955702055,2.491085643463342
NEW JERSEY,NJ,HUDSON,34017,249850,181452,65698,247150,26.582237507586488,73.41776249241352,219375,163917,49043,212960,23.02920736288505,76.97079263711495,15.428364896430026,-4.616075816514565
NEW JERSEY,NJ,HUNTERDON,34019,84242,39457,43153,82610,52.237017310252995,47.762982689747005,70836,28898,38712,67610,57.257802100281026,42.742197899718974,-8.768734750304684,11.746669653740582
NEW JERSEY,NJ,MERCER,34021,176604,122532,51641,174173,29.649256773437905,70.3507432265621,156529,104775,46193,150968,30.59787504636744,69.40212495363255,-3.100275007633757,1.3668432682188314
NEW JERSEY,NJ,MIDDLESEX,34023,374362,226250,143467,369717,38.804545098007395,61.195454901992605,326102,193044,122953,315997,38.90954660961971,61.09045339038029,-0.2698605374814478,0.17187875647497464
NEW JERSEY,NJ,MONMOUTH,34025,378151,181291,191808,373099,51.40941144307543,48.59058855692457,314377,137181,166723,303904,54.860416447299144,45.139583552700856,-6.2905191533477955,7.645185738576066
NEW JERSEY,NJ,MORRIS,34027,299322,153881,141134,295015,47.83960137620121,52.16039862379879,250416,115249,126071,241320,52.24225095309133,47.75774904690867,-8.427373431599051,9.218712491172365
NEW JERSEY,NJ,OCEAN,34029,341516,119456,217740,337196,64.57371973570268,35.426280264297326,274362,87150,179079,266229,67.26502372018075,32.73497627981925,-4.001045172709317,8.221493614269804
NEW JERSEY,NJ,PASSAIC,34031,223707,129097,92009,221106,41.613072462981556,58.386927537018444,194802,116759,72902,189661,38.43805526702907,61.56194473297093,8.260088014067435,-5.1574348564268675
NEW JERSEY,NJ,SALEM,34033,33922,14479,18827,33306,56.527352428991776,43.472647571008224,29494,11904,16381,28285,57.914088739614634,42.085911260385366,-2.3944714331217587,3.295013150702908
NEW JERSEY,NJ,SOMERSET,34035,185859,111173,71996,183169,39.3057777243966,60.6942222756034,157092,85689,65505,151194,43.32513194968054,56.67486805031946,-9.2771886533483,7.0919516243342695
NEW JERSEY,NJ,SUSSEX,34037,87960,34481,51698,86179,59.9890924703234,40.0109075296766,74126,24212,46658,70870,65.83603781571892,34.163962184281075,-8.881071126670259,17.114365464570504
NEW JERSEY,NJ,UNION,34039,252991,170245,80002,250247,31.969214416156838,68.03078558384317,221975,147414,68114,215528,31.603318362347352,68.39668163765265,1.1577773245654566,-0.5349617043526989
NEW JERSEY,NJ,WARREN,34041,60787,24901,34769,59670,58.26881179822356,41.73118820177644,49236,17281,29858,47139,63.34033390610747,36.65966609389253,-8.006781453665335,13.834065195506028
NEW MEXICO,NM,BERNALILLO,35001,317590,193757,116135,309892,37.47595936648897,62.52404063351103,274662,143417,94698,238115,39.76985910169456,60.23014089830544,-5.767935283200043,3.8085578100816253
NEW MEXICO,NM,CATRON,35003,2326,595,1698,2293,74.05146096816398,25.948539031836024,2049,427,1464,1891,77.41935483870968,22.580645161290324,-4.3501962494548625,14.914958569559534
NEW MEXICO,NM,CHAVES,35005,22443,6381,15656,22037,71.04415301538322,28.95584698461678,20271,5534,12872,18406,69.93371726610887,30.06628273389112,1.5878403046258205,-3.6932924468998096
NEW MEXICO,NM,CIBOLA,35006,8903,4745,3975,8720,45.5848623853211,54.4151376146789,8063,3741,3195,6936,46.06401384083045,53.93598615916955,-1.0401860705517407,0.8883706216019194
NEW MEXICO,NM,COLFAX,35007,6016,2611,3271,5882,55.61033662019721,44.38966337980279,5332,2129,2585,4714,54.83665676707679,45.16334323292321,1.4108807843751014,-1.713070374640513
NEW MEXICO,NM,CURRY,35009,15101,4307,10444,14751,70.80197952681173,29.198020473188258,13370,3121,9035,12156,74.32543599868377,25.674564001316224,-4.740579620595076,13.723529917358679
NEW MEXICO,NM,DE BACA,35011,901,231,656,887,73.95715896279594,26.04284103720406,910,193,620,813,76.26076260762608,23.739237392373923,-3.020693166527255,9.703781156719703
NEW MEXICO,NM,DONA ANA,35013,82641,47957,32802,80759,40.61714483834619,59.38285516165381,70648,37947,25374,63321,40.07201402378358,59.92798597621642,1.3603778792826926,-0.9096431419853723
NEW MEXICO,NM,EDDY,35015,23222,5424,17454,22878,76.29163388408078,23.708366115919222,19667,5033,13147,18180,72.31573157315732,27.684268426842685,5.497977029937506,-14.361594280267942
NEW MEXICO,NM,GRANT,35017,14435,7590,6553,14143,46.333875415399845,53.666124584600155,12811,6276,5288,11564,45.72812175717745,54.27187824282255,1.3246851935861947,-1.1161464792357911
NEW MEXICO,NM,GUADALUPE,35019,2189,1234,917,2151,42.631334263133425,57.368665736866575,1827,970,595,1565,38.019169329073485,61.980830670926515,12.131156507233287,-7.441276414230725
NEW MEXICO,NM,HARDING,35021,505,179,319,498,64.05622489959839,35.94377510040161,527,156,311,467,66.59528907922912,33.40471092077088,-3.812678366197908,7.600916486458642
NEW MEXICO,NM,HIDALGO,35023,1974,823,1120,1943,57.642820380854346,42.357179619145654,1872,784,910,1694,53.71900826446281,46.28099173553719,7.3043271705134805,-8.478236894346002
NEW MEXICO,NM,LEA,35025,20918,4061,16531,20592,80.27874902874903,19.72125097125097,17712,3930,12495,16425,76.0730593607306,23.926940639269407,5.528487618823763,-17.577214452214463
NEW MEXICO,NM,LINCOLN,35027,10306,3194,6942,10136,68.48855564325177,31.511444356748225,8902,2331,5896,8227,71.66646408168226,28.333535918317736,-4.434303379065074,11.21606723422035
NEW MEXICO,NM,LOS ALAMOS,35028,12293,7554,4278,11832,36.156186612576064,63.843813387423936,10885,5562,3359,8921,37.652729514628405,62.347270485371595,-3.9745933995858684,2.4003342735003486
NEW MEXICO,NM,LUNA,35029,8103,3563,4408,7971,55.300464182662154,44.699535817337846,7295,3195,3478,6673,52.1204855387382,47.8795144612618,6.101206869150233,-6.641626757716601
NEW MEXICO,NM,MCKINLEY,35031,26486,18029,7801,25830,30.201316298877273,69.79868370112273,21703,13576,5104,18680,27.323340471092077,72.67665952890792,10.533030654981879,-3.959972632809916
NEW MEXICO,NM,MORA,35033,2686,1745,903,2648,34.101208459214504,65.8987915407855,2441,1536,665,2201,30.213539300318036,69.78646069968197,12.867307998091926,-5.570807173653081
NEW MEXICO,NM,OTERO,35035,23571,8485,14521,23006,63.11831696079284,36.88168303920716,20060,6124,11887,18011,65.9985564377325,34.001443562267504,-4.3640946596416486,8.470932922789043
NEW MEXICO,NM,QUAY,35037,3873,1170,2634,3804,69.2429022082019,30.757097791798106,3572,1017,2212,3229,68.50418086094766,31.495819139052337,1.078359507361637,-2.3454584368573395
NEW MEXICO,NM,RIO ARRIBA,35039,16628,10990,5408,16398,32.97963166239786,67.02036833760215,14878,9592,3599,13191,27.283754074747936,72.71624592525207,20.87644380624898,-7.833019313875111
NEW MEXICO,NM,ROOSEVELT,35041,6608,1802,4634,6436,72.00124300807956,27.998756991920448,5950,1454,3884,5338,72.76133383289621,27.238666167103784,-1.044635639256264,2.7904847475043626
NEW MEXICO,NM,SAN JUAN,35045,52294,18083,32874,50957,64.51321702612006,35.48678297387994,46110,12865,27946,40811,68.47663620102423,31.523363798975765,-5.7879875455168595,12.572957632881021
NEW MEXICO,NM,SAN MIGUEL,35047,11531,7888,3421,11309,30.250243169157308,69.74975683084268,10751,7285,2313,9598,24.098770577203585,75.90122942279642,25.526084711444796,-8.104575694930949
NEW MEXICO,NM,SANDOVAL,35043,76562,40588,34174,74762,45.71038763007945,54.28961236992055,61690,27707,25905,53612,48.31940610311124,51.68059389688876,-5.399525125503968,5.048352343313245
NEW MEXICO,NM,SANTA FE,35049,82227,62530,18329,80859,22.667853918549575,77.33214608145043,71434,50793,14332,65125,22.006909788867564,77.99309021113244,3.0033482030101144,-0.8474393409631409
NEW MEXICO,NM,SIERRA,35051,5945,2265,3542,5807,60.9953504391252,39.0046495608748,5181,1612,3010,4622,65.12332323669408,34.87667676330593,-6.338701086499454,11.835912078389166
NEW MEXICO,NM,SOCORRO,35053,7160,3722,3255,6977,46.65328937938942,53.34671062061058,6868,3313,2616,5929,44.122111654579186,55.877888345420814,5.736755630886803,-4.5298378298822435
NEW MEXICO,NM,TAOS,35055,17181,13121,3715,16836,22.065811356616774,77.93418864338322,15260,10668,2727,13395,20.358342665173573,79.64165733482643,8.387071185141792,-2.143939175279508
NEW MEXICO,NM,TORRANCE,35057,7281,2344,4772,7116,67.0601461495222,32.939853850477796,6324,1785,3714,5499,67.53955264593563,32.46044735406438,-0.7098159191646358,1.4768942990349476
NEW MEXICO,NM,UNION,35059,1789,383,1388,1771,78.37380011293055,21.62619988706945,1702,320,1216,1536,79.16666666666667,20.833333333333332,-1.001515646824569,3.8057594579333776
NEW MEXICO,NM,VALENCIA,35061,32277,14263,17364,31627,54.902456761627725,45.097543238372275,27592,10841,13215,24056,54.93431992018623,45.06568007981377,-0.058002280914370985,0.07070382273623999
NEW YORK,NY,ALBANY,36001,154727,99474,51081,150555,33.92846468068148,66.07153531931853,139830,83077,47810,130887,36.527691825773374,63.472308174226626,-7.115771665752835,4.095056915146711
NEW YORK,NY,ALLEGANY,36003,20895,6048,14135,20183,70.03418718723678,29.965812812763218,18692,4882,12525,17407,71.95381168495433,28.046188315045672,-2.6678565773867735,6.8445111904484435
NEW YORK,NY,BRONX,36005,432399,355374,67740,423114,16.009869680511635,83.99013031948836,399522,353646,37797,391443,9.655811957296464,90.34418804270354,65.80552470694808,-7.033167114426631
NEW YORK,NY,BROOME,36007,93494,47010,43800,90810,48.232573505120584,51.767426494879416,86072,39212,40943,80155,51.079782920591356,48.920217079408644,-5.574043687493823,5.820107892916959
NEW YORK,NY,CATTARAUGUS,36009,35018,11879,22155,34034,65.09666803784451,34.90333196215549,31161,9497,19692,29189,67.46377059851314,32.536229401486864,-3.5087018405117076,7.275282367416724
NEW YORK,NY,CAYUGA,36011,36760,16149,19512,35661,54.715235130815174,45.284764869184826,33172,13522,17384,30906,56.24797773895037,43.75202226104963,-2.7249737141639585,3.5032497446403132
NEW YORK,NY,CHAUTAUQUA,36013,59770,23087,34853,57940,60.15360717984122,39.84639282015878,54234,19091,31594,50685,62.33402387294071,37.66597612705929,-3.4979559438421237,5.788823010305788
NEW YORK,NY,CHEMUNG,36015,39711,16636,21922,38558,56.85460864152705,43.14539135847295,36119,13757,20097,33854,59.36373840609677,40.63626159390323,-4.226704435972694,6.174607766936346
NEW YORK,NY,CHENANGO,36017,22417,8290,13482,21772,61.92357155980158,38.07642844019842,20160,6775,11921,18696,63.76230209670518,36.23769790329482,-2.883726710674406,5.0740820838302
NEW YORK,NY,CLINTON,36019,35637,18364,16514,34878,47.34789838866907,52.65210161133093,32105,15059,14449,29508,48.96638199810221,51.03361800189779,-3.3052954769986154,3.171406756567685
NEW YORK,NY,COLUMBIA,36021,35781,20386,14464,34850,41.503586800573885,58.496413199426115,30902,15284,13756,29040,47.36914600550964,52.63085399449036,-12.382657699282817,11.144715997862754
NEW YORK,NY,CORTLAND,36023,21892,10369,10789,21158,50.99253237546082,49.00746762453918,20244,8771,9900,18671,53.02340528091693,46.97659471908307,-3.8301442442193023,4.323159048885095
NEW YORK,NY,DELAWARE,36025,23074,9143,13387,22530,59.41855304039059,40.58144695960941,19792,6627,11942,18569,64.31148688674674,35.68851311325327,-7.608180253976493,13.71010843413114
NEW YORK,NY,DUTCHESS,36027,151889,81443,66872,148315,45.08781984290193,54.91218015709807,130934,62261,61797,124058,49.81299069789937,50.18700930210063,-9.485820443213633,9.415127381977051
NEW YORK,NY,ERIE,36029,476787,267174,197527,464701,42.50625671130469,57.49374328869531,423625,215456,188303,403759,46.63747433493742,53.36252566506258,-8.858150409182697,7.741795524377748
NEW YORK,NY,ESSEX,36031,19470,9947,8976,18923,47.43433916398034,52.56566083601966,17218,7762,7958,15720,50.6234096692112,49.3765903307888,-6.299596424004661,6.4586689438584255
NEW YORK,NY,FRANKLIN,36033,19420,9253,9668,18921,51.09666508112679,48.90333491887321,16952,7297,8221,15518,52.97718778193066,47.02281221806934,-3.549683891384803,3.999171066338847
NEW YORK,NY,FULTON,36035,24072,7931,15378,23309,65.97451628126474,34.02548371873525,21214,6496,13462,19958,67.45164846176972,32.548351538230285,-2.1899126473420294,4.538270329205374
NEW YORK,NY,GENESEE,36037,29431,9625,18876,28501,66.22925511385566,33.77074488614434,26432,7650,16915,24565,68.85813148788927,31.141868512110726,-3.817815437666905,8.441614134396836
NEW YORK,NY,GREENE,36039,25320,10346,14271,24617,57.9721330787667,42.0278669212333,22050,7405,13073,20478,63.83924211348764,36.16075788651236,-9.19044280677851,16.225072088185733
NEW YORK,NY,HAMILTON,36041,3489,1178,2225,3403,65.3834851601528,34.61651483984719,3225,949,2064,3013,68.50315300365085,31.496846996349152,-4.554050006036636,9.904698854014327
NEW YORK,NY,HERKIMER,36043,29560,9937,18870,28807,65.50491200055542,34.49508799944458,26255,8083,16699,24782,67.38358485997902,32.61641514002098,-2.788027474832966,5.759899888931774
NEW YORK,NY,JEFFERSON,36045,44129,17307,25629,42936,59.69116825041923,40.30883174958077,38236,13809,21763,35572,61.18014168447093,38.81985831552907,-2.433752837204761,3.8355972913380443
NEW YORK,NY,KINGS,36047,920380,703310,202772,906082,22.378989981039243,77.62101001896076,805605,640553,141044,781597,18.04561685881599,81.95438314118401,24.013438588031597,-5.287542845338833
NEW YORK,NY,LEWIS,36049,13036,3824,8894,12718,69.93237930492215,30.067620695077842,11325,3146,7400,10546,70.16878437322208,29.831215626777926,-0.33690916895825485,0.7924754768884101
NEW YORK,NY,LIVINGSTON,36051,31656,12477,18182,30659,59.30395642388858,40.69604357611142,30031,10697,17290,27987,61.77868295994569,38.22131704005431,-4.005793612760577,6.474728574799515
NEW YORK,NY,MADISON,36053,34266,14807,18408,33215,55.420743639921724,44.579256360078276,30064,11667,15936,27603,57.732855124443,42.267144875557,-4.0048452125527545,5.470233419665793
NEW YORK,NY,MONROE,36055,383499,225746,145661,371407,39.21870077839136,60.78129922160864,347790,188592,136582,325174,42.00274314674605,57.99725685325395,-6.628239395289048,4.800300082121023
NEW YORK,NY,MONTGOMERY,36057,21246,7977,12745,20722,61.50468101534601,38.49531898465399,19054,6595,11301,17896,63.14818953956191,36.85181046043809,-2.602621763504809,4.459776883907174
NEW YORK,NY,"NASSAU",36059,738369,396504,326716,723220,45.17518873924947,54.82481126075053,636967,326088,288313,614401,46.92586763367898,53.07413236632102,-3.7307331386943643,3.2985539591042556
NEW YORK,NY,NEW YORK,36061,701405,603040,85185,688225,12.377492825747394,87.6225071742526,668939,579013,64929,643942,10.083050958005535,89.91694904199447,22.75543262944799,-2.5517345641590694
NEW YORK,NY,NIAGARA,36063,104866,46029,56068,102097,54.91640302849251,45.08359697150749,92402,35559,51961,87520,59.370429616087755,40.629570383912245,-7.502095936304842,10.962524450809518
NEW YORK,NY,ONEIDA,36065,101696,41567,57180,98747,57.905556624505046,42.094443375494954,91009,33743,51437,85180,60.3862409016201,39.6137590983799,-4.108028981563083,6.262178428849241
NEW YORK,NY,ONONDAGA,36067,235686,138894,90619,229513,39.48316653087189,60.51683346912811,208440,112337,83649,195986,42.68110987519517,57.31889012480483,-7.492643358325168,5.579213654277226
NEW YORK,NY,ONTARIO,36069,60085,29025,29039,58064,50.012055662717,49.987944337283,52258,22233,26029,48262,53.93270067547967,46.06729932452033,-7.269513604285683,8.510689947643236
NEW YORK,NY,ORANGE,36071,173305,84684,84996,169680,50.091937765205095,49.908062234794905,152021,68278,76645,144923,52.886705353877574,47.11329464612243,-5.284442602298666,5.93201475223617
NEW YORK,NY,ORLEANS,36073,18314,5587,12126,17713,68.45819454637837,31.541805453621635,16380,4470,10936,15406,70.98533039075684,29.014669609243153,-3.5600818231981357,8.709855664092814
NEW YORK,NY,OSWEGO,36075,54852,21143,32138,53281,60.31793697565736,39.68206302434264,48180,17095,27688,44783,61.827032579326975,38.172967420673025,-2.440834600517783,3.9533096472147644
NEW YORK,NY,OTSEGO,36077,28223,12975,14382,27357,52.57155389845378,47.42844610154622,25668,10451,13308,23759,56.012458436802895,43.987541563197105,-6.1431057203664485,7.8224524855647015
NEW YORK,NY,PUTNAM,36079,55318,24953,29283,54236,53.991813555571945,46.008186444428055,48563,19366,27024,46390,58.25393403750808,41.74606596249192,-7.316450901310589,10.209633850925194
NEW YORK,NY,QUEENS,36081,794498,569038,212665,781703,27.205345252608726,72.79465474739128,686393,517220,149341,666561,22.404701145131504,77.5952988548685,21.426949979738485,-6.18677185128983
NEW YORK,NY,RENSSELAER,36083,79962,40969,36500,77469,47.11562044172508,52.88437955827492,71562,32717,33726,66443,50.759297442921,49.240702557079,-7.178344036958451,7.399725860881534
NEW YORK,NY,RICHMOND,36085,217899,90997,123320,214317,57.54093235720918,42.45906764279082,180960,74143,101437,175580,57.77252534457227,42.22747465542773,-0.4008704587203038,0.5484414809383553
NEW YORK,NY,ROCKLAND,36087,151381,75802,73186,148988,49.12207694579429,50.87792305420571,135087,69342,60911,130253,46.763606212524856,53.236393787475144,5.043389345447347,-4.430185002171028
NEW YORK,NY,SARATOGA,36091,133556,68471,61305,129776,47.239088891628654,52.760911108371346,114094,50913,54575,105488,51.735742454118004,48.264257545881996,-8.69158022904034,9.316736216680944
NEW YORK,NY,SCHENECTADY,36093,75381,42465,30741,73206,41.99245963445619,58.00754036554381,67280,33747,28953,62700,46.177033492822964,53.822966507177036,-9.06202400164393,7.774699407935426
NEW YORK,NY,SCHOHARIE,36095,15810,5345,9903,15248,64.94622245540398,35.05377754459601,14050,4240,8831,13071,67.56177798179175,32.43822201820825,-3.8713538993788377,8.063190161654333
NEW YORK,NY,SCHUYLER,36097,9799,3903,5621,9524,59.01931961360773,40.98068038639227,8772,3091,5050,8141,62.031691438398234,37.968308561601766,-4.85618198527119,7.933911040316888
NEW YORK,NY,SENECA,36099,15718,6914,8329,15243,54.6414747753067,45.3585252246933,13980,5697,7236,12933,55.94989561586639,44.05010438413361,-2.3385581441346726,2.9703013394696276
NEW YORK,NY,ST. LAWRENCE,36089,45267,19361,24608,43969,55.96670381405081,44.03329618594919,39158,16488,19942,36430,54.74059840790557,45.25940159209443,2.2398465522952105,-2.7090623450916396
NEW YORK,NY,STEUBEN,36101,46516,15790,29474,45264,65.11576528808766,34.884234711912335,42002,12526,26831,39357,68.17338719922758,31.826612800772416,-4.485066734625387,9.60712322822399
NEW YORK,NY,SUFFOLK,36103,757877,368000,375821,743821,50.525731325144086,49.474268674855914,681254,303951,350570,654521,53.56130666548514,46.43869333451486,-5.667478128006865,6.536737195585363
NEW YORK,NY,SULLIVAN,36105,35132,15489,18665,34154,54.649528605727,45.350471394273,29955,12568,15931,28499,55.90020702480789,44.09979297519211,-2.2373413009469822,2.8360187989645347
NEW YORK,NY,TIOGA,36107,25170,9634,14791,24425,60.5568065506653,39.4431934493347,22299,7526,13260,20786,63.792937554122965,36.207062445877035,-5.072867197426167,8.937844676836427
NEW YORK,NY,TOMPKINS,36109,46048,33619,11096,44715,24.814939058481492,75.1850609415185,42678,28890,10371,39261,26.415526858714756,73.58447314128524,-6.059268886795699,2.1751705650729702
NEW YORK,NY,ULSTER,36111,98160,57970,37590,95560,39.336542486395984,60.663457513604016,81355,42101,34006,76107,44.681829529478236,55.318170470521764,-11.962999499731254,9.662805182486434
NEW YORK,NY,WARREN,36113,36394,17642,17699,35341,50.08064287937523,49.91935712062477,31408,13091,15751,28842,54.61133069828722,45.38866930171278,-8.296241386137993,9.981979839054267
NEW YORK,NY,WASHINGTON,36115,28256,11565,15941,27506,57.954628081145934,42.045371918854066,24528,9098,13610,22708,59.9348247313722,40.0651752686278,-3.303916644624405,4.94243850663203
NEW YORK,NY,WAYNE,36117,45031,17456,26204,43660,60.01832340815392,39.98167659184608,39687,13473,23380,36853,63.44123951917076,36.55876048082924,-5.39541178097962,9.362779443279411
NEW YORK,NY,WESTCHESTER,36119,462265,312371,144713,457084,31.660044980791277,68.33995501920872,420655,272926,131238,404164,32.47147197672232,67.52852802327767,-2.4988919397085807,1.2016062243372705
NEW YORK,NY,WYOMING,36121,19483,5073,13898,18971,73.25918507195193,26.740814928048074,17298,3904,12442,16346,76.11648109629267,23.88351890370733,-3.753846713862219,11.963463323225865
NEW YORK,NY,YATES,36123,10788,4219,6208,10427,59.53773856334516,40.46226143665484,10066,3659,5660,9319,60.73613048610366,39.26386951389634,-1.9731120721177553,3.0521493107916076
NORTH CAROLINA,NC,ALAMANCE,37001,86091,38825,46056,84881,54.25949270154687,45.74050729845313,71157,29833,38815,68648,56.542069688847455,43.457930311152545,-4.036953369166829,5.25238310006404
NORTH CAROLINA,NC,ALEXANDER,37003,20236,4145,15888,20033,79.30913991913343,20.69086008086657,18271,3767,13893,17660,78.66930917327294,21.330690826727068,0.8133168481894604,-2.9995781714617364
NORTH CAROLINA,NC,ALLEGHANY,37005,6076,1486,4527,6013,75.28687843006819,24.713121569931815,5315,1306,3814,5120,74.4921875,25.5078125,1.0668111069609632,-3.1154805221662363
NORTH CAROLINA,NC,ANSON,37007,11194,5789,5321,11110,47.893789378937896,52.106210621062104,10545,5859,4506,10365,43.473227206946454,56.526772793053546,10.168470242496962,-7.820298158848149
NORTH CAROLINA,NC,ASHE,37009,15814,4164,11451,15615,73.33333333333333,26.666666666666668,13424,3500,9412,12912,72.89343246592317,27.106567534076827,0.6034849128771835,-1.622857142857137
NORTH CAROLINA,NC,AVERY,37011,9458,2191,7172,9363,76.59938054042507,23.400619459574923,8249,1689,6298,7987,78.85313634656316,21.146863653436835,-2.8581688827603813,10.65763624844578
NORTH CAROLINA,NC,BEAUFORT,37013,26315,9633,16437,26070,63.04948216340621,36.95051783659379,23938,8764,14543,23307,62.39756296391642,37.60243703608358,1.0447831109474226,-1.7337152878261652
NORTH CAROLINA,NC,BERTIE,37015,9815,5939,3817,9756,39.124641246412466,60.875358753587534,9347,5778,3456,9234,37.42690058479532,62.57309941520468,4.536150830258312,-2.7132117115563736
NORTH CAROLINA,NC,BLADEN,37017,17125,7326,9676,17002,56.91095165274674,43.08904834725326,15897,7058,8550,15608,54.779600205023065,45.220399794976935,3.8907758357977995,-4.713252110522969
NORTH CAROLINA,NC,BRUNSWICK,37019,90175,33310,55850,89160,62.6401973979363,37.3598026020637,68351,23282,42720,66002,64.7253113542014,35.27468864579861,-3.221481538890658,5.911076855141673
NORTH CAROLINA,NC,BUNCOMBE,37021,161569,96515,62412,158927,39.27086020625822,60.72913979374178,138947,75452,55716,131168,42.47682361551598,57.52317638448402,-7.54755920140574,5.573342104457435
NORTH CAROLINA,NC,BURKE,37023,44602,13118,31019,44137,70.27890432063802,29.721095679361987,38920,11251,26238,37489,69.98852996879084,30.011470031209154,0.4148884852656076,-0.9675445806060279
NORTH CAROLINA,NC,CABARRUS,37025,117227,52162,63237,115399,54.79856844513384,45.20143155486616,93289,35521,53819,89340,60.240653682561,39.759346317439,-9.03390800854239,13.687562149481792
NORTH CAROLINA,NC,CALDWELL,37027,42829,10245,32119,42364,75.81673118685677,24.183268813143236,36320,8425,26621,35046,75.96016663813273,24.03983336186726,-0.1888298270319444,0.5966574273493119
NORTH CAROLINA,NC,CAMDEN,37029,5953,1537,4312,5849,73.72200376132672,26.27799623867328,5006,1274,3546,4820,73.56846473029046,26.431535269709542,0.20870223620834683,-0.5808933513302916
NORTH CAROLINA,NC,CARTERET,37031,42695,12093,30028,42121,71.28985541653807,28.710144583461933,37781,9939,26569,36508,72.77582995507834,27.22417004492166,-2.0418517239274347,5.458291422983019
NORTH CAROLINA,NC,CASWELL,37033,12051,4860,7089,11949,59.32714034647251,40.67285965352749,11070,4792,6026,10818,55.70345720096136,44.29654279903864,6.5053110302256245,-8.180510072650172
NORTH CAROLINA,NC,CATAWBA,37035,83425,25689,56588,82277,68.77742260899157,31.22257739100842,72351,21216,48324,69540,69.4909404659189,30.509059534081103,-1.0267782420893545,2.3387081339897087
NORTH CAROLINA,NC,CHATHAM,37037,48599,26787,21186,47973,44.162341316990805,55.837658683009195,39849,21065,17105,38170,44.81268011527378,55.18731988472622,-1.4512383472938373,1.178420694538862
NORTH CAROLINA,NC,CHEROKEE,37039,16423,3583,12628,16211,77.89772376781198,22.10227623218802,14181,2860,10844,13704,79.13018096906013,20.869819030939873,-1.5575058544729514,5.905452267798816
NORTH CAROLINA,NC,CHOWAN,37041,7784,3247,4471,7718,57.929515418502206,42.070484581497794,7228,2992,4014,7006,57.293748215815015,42.706251784184985,1.109662436977188,-1.4886982025489548
NORTH CAROLINA,NC,CLAY,37043,6893,1699,5112,6811,75.05505799442079,24.94494200557921,6010,1367,4437,5804,76.44727773949,23.55272226050999,-1.8211501916569062,5.911077834953726
NORTH CAROLINA,NC,CLEVELAND,37045,51308,16955,33798,50753,66.59310779658345,33.40689220341655,44673,14964,28479,43443,65.55486499551137,34.44513500448864,1.5837768884783499,-3.0141928633370063
NORTH CAROLINA,NC,COLUMBUS,37047,26446,9446,16832,26278,64.05358094223304,35.94641905776695,23732,9063,14272,23335,61.16134561817013,38.83865438182987,4.728861497127812,-7.446795904999249
NORTH CAROLINA,NC,CRAVEN,37049,53065,21148,31032,52180,59.47106170946723,40.52893829053277,47001,17630,27731,45361,61.13401380040123,38.86598619959877,-2.720174887196891,4.278682348091722
NORTH CAROLINA,NC,CUMBERLAND,37051,147150,84469,60032,144501,41.54434917405416,58.45565082594584,127506,71605,51265,122870,41.722959225197364,58.277040774802636,-0.42808576970575496,0.3064844212550044
NORTH CAROLINA,NC,CURRITUCK,37053,16147,4195,11657,15852,73.5364622760535,26.463537723946505,12669,2913,9163,12076,75.87777409738324,24.122225902616762,-3.0856358784653426,9.706035549048387
NORTH CAROLINA,NC,DARE,37055,24232,9936,13938,23874,58.38150289017341,41.61849710982659,19609,7222,11460,18682,61.34246868643614,38.65753131356386,-4.82694267066146,7.659479784793732
NORTH CAROLINA,NC,DAVIDSON,37057,88514,22636,64658,87294,74.06923729007721,25.93076270992279,74856,18109,54317,72426,74.99654820092232,25.00345179907768,-1.2364714551405198,3.7087315715317093
NORTH CAROLINA,NC,DAVIE,37059,25311,6713,18228,24941,73.0844793713163,26.915520628683694,21756,5270,15602,20872,74.75086239938673,25.249137600613263,-2.229249234834374,6.599762155955613
NORTH CAROLINA,NC,DUPLIN,37061,22715,8767,13793,22560,61.13918439716312,38.86081560283688,20856,8283,12217,20500,59.59512195121951,40.40487804878049,2.5909208596090583,-3.8214753280024105
NORTH CAROLINA,NC,DURHAM,37063,179914,144688,32459,177147,18.323200505794624,81.67679949420538,156134,121250,28350,149600,18.950534759358288,81.04946524064171,-3.3103775778879796,0.7740140563556652
NORTH CAROLINA,NC,EDGECOMBE,37065,25477,16089,9206,25295,36.394544376358965,63.605455623641035,24886,16224,8261,24485,33.739023892178885,66.26097610782111,7.870768557698726,-4.00766882736373
NORTH CAROLINA,NC,FORSYTH,37067,201270,113033,85064,198097,42.94057961503708,57.05942038496292,178312,94464,75975,170439,44.57606533715875,55.42393466284125,-3.66897730822896,2.950865419553428
NORTH CAROLINA,NC,FRANKLIN,37069,37351,15879,20901,36780,56.82707993474715,43.17292006525285,30368,12874,16368,29242,55.97428356473566,44.02571643526434,1.5235503086434399,-1.9370414363737765
NORTH CAROLINA,NC,GASTON,37071,115498,40959,73033,113992,64.06853112499122,35.931468875008775,96431,31177,61798,92975,66.46732992739985,33.53267007260016,-3.608989265897622,7.153617046346361
NORTH CAROLINA,NC,GATES,37073,5971,2546,3367,5913,56.94233045831219,43.05766954168781,5392,2385,2874,5259,54.64917284654877,45.35082715345123,4.196143312548295,-5.05648464581292
NORTH CAROLINA,NC,GRAHAM,37075,4665,905,3710,4615,80.39003250270856,19.60996749729144,4168,768,3283,4051,81.0417180942977,18.958281905702297,-0.8041359523386027,3.43747178584326
NORTH CAROLINA,NC,GRANVILLE,37077,31598,14565,16647,31212,53.33525567089581,46.66474432910419,27353,12909,13591,26500,51.28679245283019,48.71320754716981,3.9941340062349395,-4.205149529687735
NORTH CAROLINA,NC,GREENE,37079,8753,3832,4874,8706,55.98437858947852,44.01562141052148,8095,3605,4374,7979,54.818899611480134,45.181100388519866,2.126053215694812,-2.579571918293788
NORTH CAROLINA,NC,GUILFORD,37081,284486,173086,107294,280380,38.2673514516014,61.7326485483986,257405,149248,98062,247310,39.65144959767094,60.34855040232906,-3.4906621576600294,2.293506864443473
NORTH CAROLINA,NC,HALIFAX,37083,25759,15545,10080,25625,39.33658536585366,60.66341463414634,25167,15748,9031,24779,36.44618426893741,63.55381573106259,7.930600019985357,-4.547958393477758
NORTH CAROLINA,NC,HARNETT,37085,58293,22093,35177,57270,61.42308363890344,38.57691636109656,46065,16737,27614,44351,62.262406710108,37.737593289892,-1.348041483703677,2.224103335782601
NORTH CAROLINA,NC,HAYWOOD,37087,36542,13144,22834,35978,63.46656289954972,36.53343710045028,30727,10473,18929,29402,64.37997415141827,35.620025848581726,-1.4187816380917595,2.5643194526343116
NORTH CAROLINA,NC,HENDERSON,37089,68371,27211,40032,67243,59.53333432476243,40.46666567523757,58176,19827,35809,55636,64.36300237256452,35.63699762743548,-7.503795456659423,13.552398825213974
NORTH CAROLINA,NC,HERTFORD,37091,10634,7097,3479,10576,32.895234493192135,67.10476550680787,10186,6910,3099,10009,30.962134079328603,69.0378659206714,6.2434340246402265,-2.8000581826859716
NORTH CAROLINA,NC,HOKE,37093,21639,11804,9453,21257,44.470056922425556,55.529943077574444,18230,9726,7760,17486,44.37835983072172,55.62164016927828,0.20662568885738697,-0.16485866188908904
NORTH CAROLINA,NC,HYDE,37095,2492,1046,1418,2464,57.548701298701296,42.451298701298704,2304,965,1288,2253,57.168220150909896,42.831779849090104,0.6655466040170976,-0.888315052822819
NORTH CAROLINA,NC,IREDELL,37097,102371,33888,67010,100898,66.41360581973875,33.58639418026125,82567,24734,54754,79488,68.88335346215781,31.11664653784219,-3.5854056434343917,7.937062367615688
NORTH CAROLINA,NC,JACKSON,37099,21428,9591,11356,20947,54.213013796725065,45.786986203274935,18713,7713,9870,17583,56.13376556901552,43.86623443098448,-3.4217404672931218,4.3786566073101385
NORTH CAROLINA,NC,JOHNSTON,37101,111357,41257,68353,109610,62.36018611440562,37.63981388559438,85909,28362,54372,82734,65.71905141779679,34.28094858220321,-5.1109461121673805,9.798052394427925
NORTH CAROLINA,NC,JONES,37103,5525,2197,3280,5477,59.886799342705864,40.113200657294136,5135,2065,2974,5039,59.01964675530859,40.98035324469141,1.4692608903479565,-2.1160202846948417
NORTH CAROLINA,NC,LEE,37105,29008,12143,16469,28612,57.55976513351042,42.44023486648958,25084,10469,13712,24181,56.70567801166205,43.29432198833795,1.5061756631720602,-1.9727462693108544
NORTH CAROLINA,NC,LENOIR,37107,28409,13605,14590,28195,51.746763610569246,48.253236389430754,26807,12634,13613,26247,51.86497504476702,48.13502495523298,-0.22792150983538262,0.24558299140327033
NORTH CAROLINA,NC,LINCOLN,37109,50217,13274,36341,49615,73.24599415499345,26.75400584500655,40023,9897,28806,38703,74.42833888845826,25.57166111154174,-1.588567944847885,4.623652442082293
NORTH CAROLINA,NC,MACON,37113,20743,6230,14211,20441,69.52203903918596,30.477960960814052,17734,4876,12127,17003,71.32270775745457,28.677292242545434,-2.5246780091301435,6.279075105972387
NORTH CAROLINA,NC,MADISON,37115,13076,4901,7979,12880,61.94875776397515,38.05124223602485,11269,3926,6783,10709,63.339247362031934,36.660752637968066,-2.1953048954135412,3.7928561145160744
NORTH CAROLINA,NC,MARTIN,37117,12540,5911,6532,12443,52.495378927911275,47.504621072088725,11964,5846,5897,11743,50.21715064293622,49.78284935706378,4.536753391633397,-4.57633163709581
NORTH CAROLINA,NC,MCDOWELL,37111,23003,5832,16883,22715,74.32533568126789,25.674664318732116,19875,4667,14568,19235,75.7369378736678,24.26306212633221,-1.8638226366565314,5.8179061861607595
NORTH CAROLINA,NC,MECKLENBURG,37119,567053,378107,179211,557318,32.15596840582935,67.84403159417066,472857,294562,155518,450080,34.55341272662638,65.44658727337362,-6.938372020629934,3.663207541720692
NORTH CAROLINA,NC,MITCHELL,37121,9041,1867,7090,8957,79.15596739979904,20.84403260020096,8096,1596,6282,7878,79.74105102817974,20.25894897182026,-0.7337295167754165,2.8880255791874365
NORTH CAROLINA,NC,MONTGOMERY,37123,12849,4327,8411,12738,66.03077406186215,33.96922593813785,11540,4150,7130,11280,63.209219858156025,36.790780141843975,4.463833298429876,-7.669188293446993
NORTH CAROLINA,NC,MOORE,37125,58339,20779,36764,57543,63.889612985072034,36.110387014927966,48692,16329,30490,46819,65.12313377047779,34.8768662295222,-1.8941360987836053,3.536787902009464
NORTH CAROLINA,NC,"NASH",37127,52271,25947,25827,51774,49.88411171630548,50.11588828369452,47665,23235,23319,46554,50.09021781157366,49.90978218842634,-0.4114697525243183,0.4129573126367303
NORTH CAROLINA,NC,NEW HANOVER,37129,131830,66138,63331,129469,48.915956715507185,51.084043284492815,111905,50979,55344,106323,52.052707316384975,47.947292683615025,-6.026104620864581,6.542080741817791
NORTH CAROLINA,NC,NORTHAMPTON,37131,10110,6069,3989,10058,39.659972161463514,60.340027838536486,9848,6144,3582,9726,36.82911782850093,63.17088217149907,7.6864570749285654,-4.481264525129259
NORTH CAROLINA,NC,ONSLOW,37133,72235,24266,46078,70344,65.50380984874332,34.496190151256684,57135,17514,37122,54636,67.94421260707226,32.05578739292774,-3.591774287593885,7.612986473910022
NORTH CAROLINA,NC,ORANGE,37135,84997,63594,20176,83770,24.0849946281485,75.91500537185149,82340,59923,18557,78480,23.64551478083588,76.35448521916412,1.858618225849784,-0.5755782991020975
NORTH CAROLINA,NC,PAMLICO,37137,7631,2713,4849,7562,64.12324781803756,35.876752181962445,6870,2448,4258,6706,63.49537727408291,36.50462272591709,0.9888444968905175,-1.719975436176402
NORTH CAROLINA,NC,PASQUOTANK,37139,19897,9832,9770,19602,49.841852872155904,50.158147127844096,17391,8615,8180,16795,48.70497171777315,51.29502828222685,2.33421992516607,-2.2163573984745666
NORTH CAROLINA,NC,PENDER,37141,34169,11723,21956,33679,65.19195938121678,34.80804061878322,27885,9354,17639,26993,65.34657133330863,34.65342866669136,-0.23660300599894768,0.44616639114982704
NORTH CAROLINA,NC,PERQUIMANS,37143,7484,2492,4903,7395,66.30155510480054,33.69844489519946,6708,2319,4177,6496,64.30110837438424,35.698891625615765,3.111061039210994,-5.603666218535719
NORTH CAROLINA,NC,PERSON,37145,21894,8465,13184,21649,60.89888678460899,39.10111321539101,19615,7833,11185,19018,58.812703754337996,41.187296245662004,3.5471639579520486,-5.065112839230668
NORTH CAROLINA,NC,PITT,37147,87573,47252,38982,86234,45.204907577057774,54.795092422942226,80527,41824,35691,77515,46.04399148551893,53.95600851448107,-1.822352670543459,1.555125984228356
NORTH CAROLINA,NC,POLK,37149,12358,4518,7689,12207,62.98844925043008,37.01155074956992,10934,3735,6768,10503,64.43873179091688,35.56126820908312,-2.250637931845867,4.078264396983378
NORTH CAROLINA,NC,RANDOLPH,37151,73316,15618,56894,72512,78.4614960282436,21.5385039717564,64575,13194,49430,62624,78.93140010219724,21.06859989780276,-0.5953322421054619,2.2303526396295847
NORTH CAROLINA,NC,RICHMOND,37153,20763,8754,11830,20584,57.47182277497085,42.52817722502915,19328,8501,10383,18884,54.983054437619145,45.016945562380855,4.526427938221089,-5.528514443306632
NORTH CAROLINA,NC,ROBESON,37155,47188,19020,27806,46826,59.381540169991034,40.618459830008966,40858,19016,20762,39778,52.19468047664538,47.80531952335462,13.769333632689683,-15.033598279443805
NORTH CAROLINA,NC,ROCKINGHAM,37157,47809,15992,31301,47293,66.18527054743831,33.81472945256169,42278,14228,26830,41058,65.34658288275124,34.65341711724877,1.2834453274961577,-2.42021634359868
NORTH CAROLINA,NC,ROWAN,37159,73408,23114,49297,72411,68.07943544489098,31.92056455510903,64369,19400,42810,62210,68.8153030059476,31.184696994052402,-1.0693370935139557,2.359707266666655
NORTH CAROLINA,NC,RUTHERFORD,37161,34429,9135,24891,34026,73.15288308940222,26.847116910597776,30307,7512,21871,29383,74.43419664431815,25.565803355681858,-1.7214044252249372,5.011825903100964
NORTH CAROLINA,NC,SAMPSON,37163,28618,10966,17411,28377,61.35602776896783,38.64397223103217,25928,10547,14838,25385,58.45184163876305,41.54815836123695,4.9685109122016735,-6.989927459490685
NORTH CAROLINA,NC,SCOTLAND,37165,14775,7186,7473,14659,50.978920799508835,49.021079200491165,13928,7319,6256,13575,46.08471454880295,53.91528545119705,10.620020756606841,-9.077585715716951
NORTH CAROLINA,NC,STANLY,37167,33939,8129,25458,33587,75.79718343406675,24.202816565933247,29917,7094,21964,29058,75.58675751944386,24.41324248055613,0.27838992110325034,-0.8619334969145354
NORTH CAROLINA,NC,STOKES,37169,25701,5286,20142,25428,79.21189240207646,20.78810759792355,22550,4665,17116,21781,78.58225058537258,21.417749414627426,0.8012519519529748,-2.9398131639072123
NORTH CAROLINA,NC,SURRY,37171,36638,8721,27538,36259,75.9480404864999,24.051959513500098,32196,7488,23671,31159,75.96842003915401,24.031579960845985,-0.026826347900354985,0.0848032159654677
NORTH CAROLINA,NC,SWAIN,37173,7068,2780,4161,6941,59.9481342746002,40.0518657253998,6124,2196,3565,5761,61.8816177746919,38.1183822253081,-3.124487642083662,5.072312588355321
NORTH CAROLINA,NC,TRANSYLVANIA,37175,20404,8444,11636,20080,57.94820717131474,42.05179282868526,17869,6558,10520,17078,61.59971893664363,38.40028106335637,-5.927805886719273,9.50907562187966
NORTH CAROLINA,NC,TYRRELL,37177,1817,758,1044,1802,57.93562708102109,42.06437291897891,1739,720,975,1695,57.52212389380531,42.47787610619469,0.7188593870058879,-0.9734554199038126
NORTH CAROLINA,NC,UNION,37179,131011,48725,80382,129107,62.25998590316559,37.74001409683441,105710,34337,66707,101044,66.01777443489965,33.98222556510035,-5.6920860539454,11.05810013689419
NORTH CAROLINA,NC,VANCE,37181,20999,12431,8391,20822,40.29872250504274,59.70127749495726,19977,12229,7332,19561,37.48274628086499,62.51725371913501,7.512726530433844,-4.504318498744054
NORTH CAROLINA,NC,WAKE,37183,631830,393336,226197,619533,36.51088803986228,63.48911196013772,527624,302736,196082,498818,39.3093272496181,60.6906727503819,-7.119020867453307,4.610987294976421
NORTH CAROLINA,NC,WARREN,37185,10293,6400,3752,10152,36.95823483057526,63.04176516942474,9842,6413,3214,9627,33.38527059312351,66.61472940687649,10.702217396996883,-5.363624935903322
NORTH CAROLINA,NC,WASHINGTON,37187,6205,3396,2781,6177,45.021855269548325,54.978144730451675,6165,3510,2564,6074,42.212709911096475,57.787290088903525,6.6547382633527885,-4.861182024853717
NORTH CAROLINA,NC,WATAUGA,37189,32220,17122,14451,31573,45.77012003927406,54.22987996072594,29985,14138,13697,27835,49.207831866355306,50.792168133644694,-6.986107082339665,6.768192722224242
NORTH CAROLINA,NC,WAYNE,37191,55537,24215,30709,54924,55.91180540383075,44.08819459616925,50689,21770,27540,49310,55.850740214966535,44.149259785033465,0.1093364002503483,-0.1383153175422258
NORTH CAROLINA,NC,WILKES,37193,35466,7511,27592,35103,78.60296840725864,21.39703159274136,31296,6638,23752,30390,78.15728858177032,21.84271141822968,0.5702345022141397,-2.040405226964448
NORTH CAROLINA,NC,WILSON,37195,40735,20754,19581,40335,48.5459278542209,51.4540721457791,38135,19663,17531,37194,47.133946335430444,52.866053664569556,2.9956785471389136,-2.6708661246957366
NORTH CAROLINA,NC,YADKIN,37197,19923,3763,15933,19696,80.89459788789603,19.10540211210398,17624,3160,13880,17040,81.45539906103286,18.544600938967136,-0.6884763681737516,3.0240670855227414
NORTH CAROLINA,NC,YANCEY,37199,11352,3688,7516,11204,67.0831845769368,32.91681542306319,9960,3196,6385,9581,66.64231291096962,33.35768708903037,0.6615491670526996,-1.3216493841149979
NORTH DAKOTA,ND,ADAMS,38001,1269,258,981,1239,79.17675544794189,20.82324455205811,1218,216,909,1125,80.8,19.2,-2.0089660297748946,8.454398708636003
NORTH DAKOTA,ND,BARNES,38003,5565,1820,3568,5388,66.22123236822569,33.778767631774315,5344,1597,3160,4757,66.42842127391214,33.57157872608787,-0.3118979823893864,0.617155682122994
NORTH DAKOTA,ND,BENSON,38005,1961,822,1094,1916,57.09812108559499,42.90187891440501,2011,842,929,1771,52.45623941276115,47.54376058723885,8.849055374153636,-9.763387699036496
NORTH DAKOTA,ND,BILLINGS,38007,635,72,541,613,88.25448613376835,11.745513866231647,605,59,495,554,89.35018050541517,10.649819494584838,-1.2262922866511872,10.288384438853093
NORTH DAKOTA,ND,BOTTINEAU,38009,3471,821,2575,3396,75.82449941107186,24.175500588928152,3494,736,2494,3230,77.21362229102168,22.78637770897833,-1.7990645157329288,6.096286551953711
NORTH DAKOTA,ND,BOWMAN,38011,1657,228,1395,1623,85.95194085027727,14.048059149722736,1787,227,1446,1673,86.43156007172743,13.568439928272564,-0.5549121421065895,3.5348147906878236
NORTH DAKOTA,ND,BURKE,38013,1155,137,994,1131,87.8868258178603,12.1131741821397,1052,119,895,1014,88.26429980276134,11.735700197238659,-0.4276632633404054,3.2164589973920688
NORTH DAKOTA,ND,BURLEIGH,38015,50753,14348,34744,49092,70.77324207610201,29.22675792389799,47979,10881,32532,43413,74.93607905466105,25.063920945338953,-5.555183872807811,16.608881697471123
NORTH DAKOTA,ND,CASS,38017,86053,40311,42619,82930,51.391535029542986,48.608464970457014,80821,31361,39816,71177,55.9394186324234,44.0605813675766,-8.130015852979177,10.32188741437514
NORTH DAKOTA,ND,CAVALIER,38019,2020,474,1499,1973,75.97567156614294,24.02432843385707,2006,476,1357,1833,74.0316421167485,25.9683578832515,2.6259439799115603,-7.4861470183613115
NORTH DAKOTA,ND,DICKEY,38021,2424,608,1742,2350,74.12765957446808,25.872340425531913,2407,554,1667,2221,75.056280954525,24.94371904547501,-1.2372334043829647,3.7228665796144034
NORTH DAKOTA,ND,DIVIDE,38023,1202,265,904,1169,77.33105218135158,22.668947818648416,1219,245,867,1112,77.96762589928058,22.032374100719423,-0.8164590246102055,2.889265201375668
NORTH DAKOTA,ND,DUNN,38025,2338,342,1951,2293,85.08504143044047,14.914958569559529,2243,358,1771,2129,83.18459370596524,16.81540629403476,2.284615022816361,-11.301824596111077
NORTH DAKOTA,ND,EDDY,38027,1261,383,854,1237,69.03799514955537,30.962004850444625,1231,355,791,1146,69.02268760907505,30.977312390924958,0.0221775491661802,-0.0494153278604581
NORTH DAKOTA,ND,EMMONS,38029,2009,237,1738,1975,88,12,1981,215,1677,1892,88.63636363636364,11.363636363636363,-0.7179487179487243,5.600000000000005
NORTH DAKOTA,ND,FOSTER,38031,1778,373,1362,1735,78.5014409221902,21.498559077809798,1719,347,1241,1588,78.1486146095718,21.851385390428213,0.45148121227882587,-1.614663355729229
NORTH DAKOTA,ND,GOLDEN VALLEY,38033,1026,137,871,1008,86.40873015873017,13.591269841269842,957,99,796,895,88.93854748603351,11.061452513966481,-2.8444554119805288,22.870570787237444
NORTH DAKOTA,ND,GRAND FORKS,38035,30970,12880,16987,29867,56.875481300431915,43.124518699568085,30365,10851,16340,27191,60.09341326174102,39.90658673825898,-5.35488298408543,8.063661225689422
NORTH DAKOTA,ND,GRANT,38037,1381,207,1145,1352,84.68934911242603,15.310650887573965,1381,185,1108,1293,85.69218870843001,14.307811291569992,-1.1702812253006734,7.009035662881824
NORTH DAKOTA,ND,GRIGGS,38039,1250,308,907,1215,74.65020576131687,25.349794238683128,1265,298,847,1145,73.97379912663756,26.026200873362445,0.9143867729726196,-2.598944955395366
NORTH DAKOTA,ND,HETTINGER,38041,1312,196,1091,1287,84.77078477078477,15.22921522921523,1296,168,1050,1218,86.20689655172414,13.793103448275861,-1.665889665889675,10.411810411810428
NORTH DAKOTA,ND,KIDDER,38043,1460,221,1215,1436,84.6100278551532,15.389972144846796,1376,179,1111,1290,86.12403100775194,13.875968992248062,-1.7579334535124835,10.91097244051602
NORTH DAKOTA,ND,LAMOURE,38045,2219,527,1645,2172,75.7366482504604,24.263351749539595,2151,502,1481,1983,74.68482097831568,25.315179021684315,1.4083548147623137,-4.154927252316698
NORTH DAKOTA,ND,LOGAN,38047,1076,128,930,1058,87.90170132325142,12.098298676748582,1067,114,888,1002,88.62275449101796,11.377245508982035,-0.8136208041690018,6.3376778430007
NORTH DAKOTA,ND,MCHENRY,38049,3003,564,2364,2928,80.73770491803279,19.262295081967213,2820,490,2050,2540,80.70866141732283,19.291338582677167,0.0359856057577046,-0.15055202408832402
NORTH DAKOTA,ND,MCINTOSH,38051,1455,261,1153,1414,81.54172560113155,18.458274398868458,1446,235,1100,1335,82.39700374531836,17.60299625468165,-1.0379966568085375,4.858707755273994
NORTH DAKOTA,ND,MCKENZIE,38053,5419,814,4482,5296,84.62990936555892,15.370090634441087,4672,698,3670,4368,84.02014652014653,15.97985347985348,0.7257340895807429,-3.815822505388722
NORTH DAKOTA,ND,MCLEAN,38055,5536,1230,4198,5428,77.33971997052322,22.660280029476787,5315,1081,3860,4941,78.12183768467922,21.878162315320786,-1.0011511983535781,3.574878469606668
NORTH DAKOTA,ND,MERCER,38057,4675,704,3856,4560,84.56140350877193,15.43859649122807,4682,621,3759,4380,85.82191780821918,14.178082191780822,-1.4687556881029407,8.890583947792186
NORTH DAKOTA,ND,MORTON,38059,16619,3872,12243,16115,75.97269624573379,24.02730375426621,15832,3080,11336,14416,78.63485016648168,21.365149833518313,-3.3854632076130597,12.460263286201844
NORTH DAKOTA,ND,MOUNTRAIL,38061,4165,1256,2824,4080,69.2156862745098,30.784313725490197,4106,1220,2582,3802,67.91162546028406,32.088374539715936,1.9202320742394585,-4.063966570234645
NORTH DAKOTA,ND,NELSON,38063,1777,586,1141,1727,66.06832657788071,33.93167342211928,1717,536,1025,1561,65.66303651505446,34.33696348494555,0.6172271103139337,-1.1803316941638164
NORTH DAKOTA,ND,OLIVER,38065,1066,129,918,1047,87.67908309455588,12.320916905444125,1017,119,830,949,87.4604847207587,12.539515279241307,0.24993958642594016,-1.74327610700441
NORTH DAKOTA,ND,PEMBINA,38067,3331,786,2460,3246,75.78558225508318,24.21441774491682,3153,681,2208,2889,76.42782969885774,23.572170301142265,-0.8403319135256715,2.7246003892286152
NORTH DAKOTA,ND,PIERCE,38069,2128,497,1585,2082,76.12872238232468,23.87127761767531,2071,431,1437,1868,76.9271948608137,23.072805139186297,-1.0379586567971333,3.460664941571867
NORTH DAKOTA,ND,RAMSEY,38071,5372,1639,3577,5216,68.57745398773007,31.42254601226994,5305,1505,3217,4722,68.12791190173655,31.872088098263447,0.6598500870566903,-1.4104569634959097
NORTH DAKOTA,ND,RANSOM,38073,2454,945,1418,2363,60.00846381718155,39.99153618281845,2359,838,1210,2048,59.08203125,40.91796875,1.5680445434610002,-2.264121596166846
NORTH DAKOTA,ND,RENVILLE,38075,1319,220,1065,1285,82.87937743190662,17.120622568093385,1293,201,993,1194,83.16582914572864,16.834170854271356,-0.3444343870125821,1.7016086880771164
NORTH DAKOTA,ND,RICHLAND,38077,7812,2510,5072,7582,66.89527829068847,33.10472170931153,7592,2064,4767,6831,69.78480456741326,30.215195432586736,-4.140623871681781,9.563156005962714
NORTH DAKOTA,ND,ROLETTE,38079,3804,2482,1257,3739,33.61861460283498,66.38138539716502,3755,2099,1217,3316,36.70084439083233,63.29915560916767,-8.398253062447992,4.869306325392664
NORTH DAKOTA,ND,SARGENT,38081,2070,738,1266,2004,63.17365269461078,36.82634730538922,1997,694,1088,1782,61.05499438832772,38.94500561167228,3.470081895033461,-5.440128388755639
NORTH DAKOTA,ND,SHERIDAN,38083,812,104,688,792,86.86868686868686,13.131313131313131,787,95,650,745,87.24832214765101,12.751677852348994,-0.43512043512043963,2.977139819245078
NORTH DAKOTA,ND,SIOUX,38085,1186,804,258,1062,24.293785310734464,75.70621468926554,1232,758,260,1018,25.540275049115913,74.45972495088408,-4.88048674489352,1.6740455853196945
NORTH DAKOTA,ND,SLOPE,38087,427,44,380,424,89.62264150943396,10.377358490566039,430,43,362,405,89.38271604938272,10.617283950617283,0.2684248931512423,-2.25976305397102
NORTH DAKOTA,ND,STARK,38089,15050,2499,12110,14609,82.8941063727839,17.1058936272161,12322,1753,9755,11508,84.76711852624261,15.232881473757386,-2.209597525576923,12.295849322306275
NORTH DAKOTA,ND,STEELE,38091,1088,392,652,1044,62.452107279693486,37.547892720306514,999,361,538,899,59.844271412680754,40.155728587319246,4.357703428335391,-6.494305940289324
NORTH DAKOTA,ND,STUTSMAN,38093,9959,2676,6994,9670,72.32678386763185,27.67321613236815,10155,2498,6718,9216,72.89496527777777,27.10503472222222,-0.7794521994499592,2.0962209271036425
NORTH DAKOTA,ND,TOWNER,38095,1174,317,830,1147,72.36268526591107,27.63731473408893,1157,305,733,1038,70.61657032755299,29.383429672447015,2.4726702674156664,-5.9425157574285015
NORTH DAKOTA,ND,TRAILL,38097,4136,1493,2522,4015,62.81444582814446,37.18555417185554,3933,1241,2265,3506,64.60353679406731,35.39646320593269,-2.769339040408614,5.054434267949648
NORTH DAKOTA,ND,WALSH,38099,4783,1333,3324,4657,71.37642258964999,28.62357741035001,4636,1167,2995,4162,71.96059586737145,28.039404132628544,-0.8117960540489855,2.0834011841274425
NORTH DAKOTA,ND,WARD,38101,28246,7293,19974,27267,73.2533832104742,26.7466167895258,27412,5806,18636,24442,76.2458063988217,23.7541936011783,-3.924705278471219,12.597452216601713
NORTH DAKOTA,ND,WELLS,38103,2374,442,1893,2335,81.07066381156316,18.92933618843683,2383,419,1796,2215,81.08352144469526,18.91647855530474,-0.01585727026035544,0.06797054269114255
NORTH DAKOTA,ND,WILLIAMS,38105,14334,2169,11739,13908,84.404659188956,15.595340811044004,12807,1735,10069,11804,85.3015926804473,14.698407319552693,-1.0514850465352277,6.1022495294313694
OHIO,OH,ADAMS,39001,12145,2156,9870,12026,82.07217694994179,17.92782305005821,11359,2326,8659,10985,78.82567137005007,21.174328629949933,4.118589189873023,-15.332271623005411
OHIO,OH,ALLEN,39003,48006,14149,33116,47265,70.06452977890616,29.935470221093833,45894,13294,30487,43781,69.63522989424636,30.36477010575364,0.6164981221599586,-1.4138091056334345
OHIO,OH,ASHLAND,39005,26405,6541,19407,25948,74.79189147525821,25.208108524741792,24590,5740,17493,23233,75.29376318168123,24.70623681831877,-0.6665514980464193,2.0313563336805007
OHIO,OH,ASHTABULA,39007,44147,16497,26890,43387,61.97708991172471,38.02291008827529,40867,15577,23318,38895,59.95115053348759,40.04884946651241,3.3793169275466495,-5.058670611576854
OHIO,OH,ATHENS,39009,26059,14772,10862,25634,42.37341031442615,57.62658968557385,29443,16370,11354,27724,40.95368633674794,59.04631366325206,3.4666573504624543,-2.4044244078894716
OHIO,OH,AUGLAIZE,39011,25777,4651,20798,25449,81.72423277928405,18.27576722071594,23627,3980,18658,22638,82.41894160261508,17.58105839738493,-0.8428994716779825,3.9514618951174585
OHIO,OH,BELMONT,39013,33088,9138,23560,32698,72.05333659551043,27.94666340448957,31122,8785,21108,29893,70.61184892784264,29.38815107215736,2.0414246186087226,-4.9049961126457875
OHIO,OH,BROWN,39015,21096,4380,16480,20860,79.00287631831256,20.99712368168744,19607,4353,14573,18926,76.99989432526682,23.00010567473317,2.601278885636704,-8.708577349042834
OHIO,OH,BUTLER,39017,186737,69613,114392,184005,62.16787587293823,37.83212412706177,173839,58642,106976,165618,64.5920129454528,35.40798705454721,-3.7529981834777626,6.846300154764773
OHIO,OH,CARROLL,39019,14212,3251,10745,13996,76.7719348385253,23.228065161474706,13074,3154,9254,12408,74.58091553836235,25.419084461637652,2.9377747435078705,-8.619583854287205
OHIO,OH,CHAMPAIGN,39021,19972,5062,14589,19651,74.2404966668363,25.759503333163707,18104,4594,12631,17225,73.32946298984035,26.670537010159652,1.2423842202719637,-3.4158805150751315
OHIO,OH,CLARK,39023,64212,24076,39032,63108,61.84952779362363,38.15047220637637,61429,23328,35205,58533,60.145558915483576,39.854441084516424,2.8330751411496102,-4.275480553162369
OHIO,OH,CLERMONT,39025,110480,34092,74570,108662,68.62564650015645,31.37435349984355,99121,26715,67518,94233,71.6500588965649,28.349941103435103,-4.2210885001149006,10.668143490576721
OHIO,OH,CLINTON,39027,20527,4697,15488,20185,76.73024523160763,23.26975476839237,18675,4066,13838,17904,77.2899910634495,22.71000893655049,-0.7242151592207757,2.4647539039097444
OHIO,OH,COLUMBIANA,39029,49860,13359,35726,49085,72.78394621574819,27.21605378425181,46201,12432,31676,44108,71.81463680058039,28.185363199419605,1.3497379619971328,-3.4390524199019556
OHIO,OH,COSHOCTON,39031,16739,4125,12325,16450,74.92401215805471,25.075987841945288,15552,4013,10785,14798,72.8814704689823,27.118529531017707,2.8025527969303132,-7.531904289781622
OHIO,OH,CRAWFORD,39033,20686,4916,15436,20352,75.84512578616352,24.15487421383648,19237,4625,13611,18236,74.63807852599254,25.361921474007456,1.6172003406419888,-4.759289478157392
OHIO,OH,CUYAHOGA,39035,625670,416176,202699,618875,32.752817612603515,67.24718238739649,603822,398271,184211,582482,31.625183267465776,68.37481673253423,3.5656215352205978,-1.6491954187588864
OHIO,OH,DARKE,39037,27134,4731,22004,26735,82.30409575462876,17.695904245371235,25484,4470,20012,24482,81.74168777060697,18.258312229393024,0.688030794764205,-3.0802846230025605
OHIO,OH,DEFIANCE,39039,19381,5981,13038,19019,68.5525001314475,31.4474998685525,18192,5368,11688,17056,68.52720450281426,31.47279549718574,0.03691326505550485,-0.08037299589577218
OHIO,OH,DELAWARE,39041,126070,57735,66356,124091,53.473660458856806,46.526339541143194,103860,40872,57568,98440,58.480292563998375,41.519707436001625,-8.561229579456231,12.058447456208077
OHIO,OH,ERIE,39043,40335,17493,22160,39653,55.884800645600585,44.115199354399415,37578,16057,19648,35705,55.02870746394063,44.97129253605937,1.555721042913727,-1.9036437099812398
OHIO,OH,FAIRFIELD,39045,83311,31224,50797,82021,61.931700418185585,38.068299581814415,72913,24881,44314,69195,64.04219958089458,35.957800419105425,-3.295482004866379,5.869377820973787
OHIO,OH,FAYETTE,39047,12612,2975,9473,12448,76.10057840616966,23.899421593830333,11162,2739,7995,10734,74.48295136948016,25.517048630519845,2.171808456763613,-6.339397083543341
OHIO,OH,FRANKLIN,39049,630577,409144,211237,620381,34.04955986724287,65.95044013275712,581140,351198,199331,550529,36.20717528050294,63.79282471949706,-5.959082409894356,3.382222722927364
OHIO,OH,FULTON,39051,22770,6664,15731,22395,70.2433578923867,29.756642107613306,21225,6069,13709,19778,69.31438972595814,30.685610274041863,1.3402241152253414,-3.0273739323816162
OHIO,OH,GALLIA,39053,13799,2990,10645,13635,78.07114044737807,21.92885955262193,12931,2628,9822,12450,78.89156626506023,21.10843373493976,-1.0399410944963328,3.8867204833116453
OHIO,OH,GEAUGA,39055,56021,21201,34143,55344,61.69232437120555,38.30767562879445,49941,17569,30227,47796,63.241693865595444,36.758306134404556,-2.4499177673556582,4.21501874630652
OHIO,OH,GREENE,39057,88643,34798,52072,86870,59.942442730516866,40.057557269483134,81858,28943,48540,77483,62.64599976769098,37.35400023230902,-4.315610010534854,7.237664026236468
OHIO,OH,GUERNSEY,39059,18230,4577,13407,17984,74.54959964412811,25.450400355871885,16557,4359,11445,15804,72.41837509491268,27.58162490508732,2.9429334011184416,-7.726972419316525
OHIO,OH,HAMILTON,39061,430929,246266,177886,424152,41.939210471717686,58.060789528282314,409109,215719,173665,389384,44.59993220060403,55.40006779939597,-5.965752855674311,4.80274092537365
OHIO,OH,HANCOCK,39063,38771,11757,26310,38067,69.11498148002207,30.885018519977933,36023,9609,24183,33792,71.56427556818181,28.435724431818183,-3.4225094416364454,8.613440090237724
OHIO,OH,HARDIN,39065,13247,3062,9949,13011,76.46606717392976,23.53393282607025,12294,2920,8717,11637,74.90762223940878,25.09237776059122,2.0804891250453927,-6.210830035281001
OHIO,OH,HARRISON,39067,7655,1768,5792,7560,76.6137566137566,23.386243386243386,7079,1688,5098,6786,75.12525788387858,24.874742116121425,1.9813559005398718,-5.983976529000223
OHIO,OH,HENRY,39069,14764,4062,10479,14541,72.06519496595833,27.934805034041677,13932,3756,9301,13057,71.23382093895995,28.766179061040056,1.1671057596514212,-2.8901093371985764
OHIO,OH,HIGHLAND,39071,19676,3799,15678,19477,80.49494275299071,19.505057247009294,18501,3773,14020,17793,78.79503175406059,21.204968245939416,2.157383481024522,-8.016569415309737
OHIO,OH,HOCKING,39073,13824,3880,9737,13617,71.50620547844606,28.49379452155394,12838,3775,8497,12272,69.23891786179922,30.76108213820078,3.2745855750841546,-7.37063672357352
OHIO,OH,HOLMES,39075,12947,1994,10796,12790,84.40969507427678,15.59030492572322,11054,1788,8720,10508,82.98439284354777,17.015607156452226,1.717554568864732,-8.376440626678072
OHIO,OH,HURON,39077,27190,7759,18956,26715,70.95639154033314,29.043608459666853,24834,7192,16226,23418,69.28858143308567,30.71141856691434,2.4070490010798418,-5.430586358665412
OHIO,OH,JACKSON,39079,14794,3311,11309,14620,77.3529411764706,22.647058823529413,13693,3226,9949,13175,75.51423149905123,24.485768500948765,2.4349180822193173,-7.509299442033468
OHIO,OH,JEFFERSON,39081,33362,10018,22828,32846,69.50009133532241,30.499908664677587,32201,9675,21117,30792,68.57950116913484,31.42049883086516,1.342369294750556,-2.929903090154806
OHIO,OH,KNOX,39083,31398,8589,22340,30929,72.22994600536713,27.770053994632868,28687,8171,19131,27302,70.0717896124826,29.9282103875174,3.0799218984126853,-7.2111107377962895
OHIO,OH,LAKE,39085,130509,55514,73278,128792,56.896391080191314,43.103608919808686,116246,46397,64255,110652,58.069442938220725,41.930557061779275,-2.020084572323866,2.7976061856298973
OHIO,OH,LAWRENCE,39087,28127,7489,20306,27795,73.05630509084368,26.943694909156324,26607,6974,18689,25663,72.82468924132019,27.17531075867981,0.31804577806846535,-0.8523024872843732
OHIO,OH,LICKING,39089,94210,33055,59514,92569,64.29150147457572,35.708498525424275,82761,27376,51241,78617,65.17801493315694,34.82198506684305,-1.3601418507304674,2.545844117960261
OHIO,OH,LOGAN,39091,23368,5055,17964,23019,78.03988009904862,21.960119900951387,21571,4647,15957,20604,77.44612696563775,22.553873034362258,0.7666660124583391,-2.6325994320631763
OHIO,OH,LORAIN,39093,157437,75667,79520,155187,51.24140553010239,48.75859446989761,140562,66949,66818,133767,49.951034261065885,50.048965738934115,2.583272374887091,-2.5782176514243083
OHIO,OH,LUCAS,39095,200623,115411,81763,197174,41.467434854494,58.532565145506,197556,110833,75698,186531,40.58199441379717,59.41800558620283,2.1818554102303933,-1.4901887600590191
OHIO,OH,MADISON,39097,19855,5698,13835,19533,70.82885373470538,29.17114626529463,17290,4779,11631,16410,70.87751371115174,29.122486288848265,-0.06865361649770474,0.1670873014197216
OHIO,OH,MAHONING,39099,118966,57641,59903,117544,50.96219288096373,49.03780711903627,115072,57381,53616,110997,48.304008216438284,51.695991783561716,5.503031244560019,-5.1419550584397395
OHIO,OH,MARION,39101,27818,8269,19023,27292,69.70174410083541,30.29825589916459,26322,7928,16961,24889,68.14657077423762,31.853429225762383,2.2821006382697018,-4.882279127862321
OHIO,OH,MEDINA,39103,105825,39800,64598,104398,61.87666430391387,38.12333569608613,91373,32182,54810,86992,63.00579363619643,36.99420636380357,-1.7921039750761647,3.0521788227557245
OHIO,OH,MEIGS,39105,10951,2492,8316,10808,76.94300518134715,23.05699481865285,9985,2260,7309,9569,76.38206709165011,23.61793290834988,0.7343845369148783,-2.375051584208343
OHIO,OH,MERCER,39107,23761,4030,19452,23482,82.83791840558726,17.16208159441274,21726,3384,17506,20890,83.80086165629488,16.199138343705123,-1.1490851426529392,5.944410315390702
OHIO,OH,MIAMI,39109,57972,15663,41371,57034,72.53743381141074,27.462566188589264,52734,13120,37079,50199,73.86402119564134,26.135978804358654,-1.7959858707352505,5.075713422331729
OHIO,OH,MONROE,39111,7148,1605,5463,7068,77.29202037351443,22.707979626485567,6795,1662,4868,6530,74.54823889739663,25.45176110260337,3.6805449956962333,-10.780320721449609
OHIO,OH,MONTGOMERY,39113,268505,135064,129034,264098,48.85837832925657,51.14162167074343,258301,122016,123909,245925,50.38487343702348,49.61512656297652,-3.0296694298039495,3.0766728083003736
OHIO,OH,MORGAN,39115,6847,1725,5041,6766,74.50487732781555,25.49512267218445,6443,1736,4431,6167,71.85017026106696,28.14982973893303,3.6947818733104265,-9.430632765344749
OHIO,OH,MORROW,39117,18457,4048,14077,18125,77.66620689655173,22.333793103448276,16548,3761,11948,15709,76.05831052263034,23.94168947736966,2.1140311464622696,-6.715885173605695
OHIO,OH,MUSKINGUM,39119,40465,11971,27867,39838,69.95080074300918,30.049199256990814,36991,11123,24056,35179,68.38170499445692,31.61829500554308,2.2946133745560315,-4.962619737329865
OHIO,OH,NOBLE,39121,6343,1170,5135,6305,81.44329896907216,18.556701030927837,6013,1221,4549,5770,78.83882149046794,21.161178509532064,3.3035469447233234,-12.307809215025712
OHIO,OH,OTTAWA,39123,24007,9008,14628,23636,61.888644440683706,38.111355559316294,22218,8285,12653,20938,60.430795682491166,39.569204317508834,2.4124268789248005,-3.6843014241442873
OHIO,OH,PAULDING,39125,9467,2213,7086,9299,76.20174212280891,23.798257877191094,9047,2093,6500,8593,75.642965204236,24.357034795763994,0.7387030863533761,-2.2941089638303547
OHIO,OH,PERRY,39127,16675,4098,12357,16455,75.09571558796718,24.904284412032816,14995,4138,10228,14366,71.19587915912571,28.804120840874287,5.477615382942558,-13.539161463686945
OHIO,OH,PICKAWAY,39129,28271,7304,20593,27897,73.81797325877335,26.182026741226654,24745,6529,17076,23605,72.34060580385511,27.659394196144884,2.042238157258436,-5.341286379743426
OHIO,OH,PIKE,39131,12412,3110,9157,12267,74.64742805902013,25.352571940979864,11879,3539,7902,11441,69.06738921422952,30.932610785770475,8.079122301094577,-18.03934004612867
OHIO,OH,PORTAGE,39133,82872,35661,45990,81651,56.32509093581218,43.67490906418782,76139,32397,39971,72368,55.2329759009507,44.7670240990493,1.977288054911197,-2.439552453710392
OHIO,OH,PREBLE,39135,21809,4493,17022,21515,79.11689518940274,20.883104810597256,20565,4325,15446,19771,78.1245258206464,21.8754741793536,1.2702405017274154,-4.536447350215411
OHIO,OH,PUTNAM,39137,19921,3195,16412,19607,83.70479930637018,16.295200693629827,18767,2922,14961,17883,83.660459654420393,16.3395403455796,0.05299953183730555,-0.2713641327234062
OHIO,OH,RICHLAND,39139,59975,17640,41472,59112,70.15834348355664,29.84165651644336,55214,16085,36590,52675,69.46369245372567,30.536307546274323,1.0000203059947088,-2.274836369060984
OHIO,OH,ROSS,39141,33299,10557,22278,32835,67.84833257195066,32.151667428049336,30380,10356,18652,29008,64.29950358521788,35.70049641478213,5.519216772847124,-9.940559216603406
OHIO,OH,SANDUSKY,39143,30074,10596,18896,29492,64.07161264071613,35.928387359283875,28044,9929,16316,26245,62.1680320060964,37.831967993903604,3.061992752855769,-5.031672248524
OHIO,OH,SCIOTO,39145,32047,9080,22609,31689,71.34652403042065,28.65347596957935,30784,9132,20550,29682,69.23387911865777,30.76612088134223,3.0514611324061303,-6.866789999008516
OHIO,OH,SENECA,39147,25810,8266,17086,25352,67.39507731145471,32.60492268854528,23987,7404,14825,22229,66.69215889153809,33.30784110846192,1.0539746075094003,-2.110369199936124
OHIO,OH,SHELBY,39149,25258,4465,20422,24887,82.05890625627838,17.941093743721623,23740,4243,18590,22833,81.41724696710901,18.58275303289099,0.7881122404305607,-3.4529829247240573
OHIO,OH,STARK,39151,189879,75904,111097,187001,59.40984272811375,40.59015727188625,175239,68146,98388,166534,59.07982754272401,40.92017245727599,0.558591991743862,-0.8064853239176939
OHIO,OH,SUMMIT,39153,280473,151668,124833,276501,45.147395488623914,54.852604511376086,257979,134256,112026,246282,45.48688089263527,54.51311910736473,-0.7463369599086334,0.6227590891336288
OHIO,OH,TRUMBULL,39155,101001,44519,55194,99713,55.3528627159949,44.6471372840051,96029,43014,49024,92038,53.2649557791347,46.7350442208653,3.919851065901181,-4.467540304429695
OHIO,OH,TUSCARAWAS,39157,44015,12889,30458,43347,70.26553164002122,29.734468359978777,41289,12188,26918,39106,68.83342709558636,31.166572904413645,2.0805364557050954,-4.595001666776333
OHIO,OH,UNION,39159,33445,11141,21669,32810,66.04388905821396,33.956110941786044,27429,7718,18096,25814,70.10149531262105,29.898504687378942,-5.788187878606577,13.571268184926776
OHIO,OH,VAN WERT,39161,14965,3067,11650,14717,79.1601549228783,20.839845077121694,13770,2697,10469,13166,79.51541850220265,20.484581497797357,-0.4467857756599747,1.7342974732607486
OHIO,OH,VINTON,39163,6030,1331,4632,5963,77.67902062720107,22.320979372798927,5502,1351,3883,5234,74.18800152846771,25.811998471532288,4.705638414311197,-13.524791978364481
OHIO,OH,WARREN,39165,136100,46069,87988,134057,65.63476730047667,34.36523269952334,117267,33730,77643,111373,69.71438319880043,30.285616801199573,-5.851899867908406,13.470473212096445
OHIO,OH,WASHINGTON,39167,32031,9243,22307,31550,70.70364500792392,29.29635499207607,29840,8026,20514,28540,71.8780658724597,28.121934127540296,-1.6339071596885524,4.1761738691566075
OHIO,OH,WAYNE,39169,54283,16660,36759,53419,68.81259476965124,31.18740523034875,49853,15031,32270,47301,68.22265914039872,31.777340859601278,0.8647209544243362,-1.8564663162313755
OHIO,OH,WILLIAMS,39171,18651,4842,13452,18294,73.53230567399147,26.467694326008527,17308,4358,11939,16297,73.2588820028226,26.741117997177394,0.3732293801021136,-1.0224840681594793
OHIO,OH,WOOD,39173,67597,30617,35757,66374,53.87199807153404,46.12800192846596,64341,27318,32498,59816,54.3299451651732,45.6700548348268,-0.8428999739405585,1.0027294587129365
OHIO,OH,WYANDOT,39175,11390,2733,8462,11195,75.58731576596695,24.41268423403305,10592,2515,7468,9983,74.80717219272763,25.192827807272362,1.0428726957214973,-3.0966891815698006
OKLAHOMA,OK,ADAIR,40001,7108,1387,5585,6972,80.1061388410786,19.8938611589214,6513,1382,4787,6169,77.59766574809531,22.402334251904684,3.232665659204925,-11.19737374139933
OKLAHOMA,OK,ALFALFA,40003,2262,232,1978,2210,89.50226244343891,10.497737556561086,2258,216,1933,2149,89.94881340158213,10.05118659841787,-0.4964500822813189,4.442768560415611
OKLAHOMA,OK,ATOKA,40005,5389,765,4557,5322,85.62570462232243,14.374295377677566,5018,795,4084,4879,83.70567739290838,16.294322607091615,2.293783754238765,-11.783412392844216
OKLAHOMA,OK,BEAVER,40007,2178,190,1968,2158,91.19555143651529,8.8044485634847085,2243,176,1993,2169,91.88566159520516,8.114338404794836,-0.7510531531351394,8.504823489763268
OKLAHOMA,OK,BECKHAM,40009,7948,1048,6767,7815,86.58989123480487,13.410108765195137,7552,960,6308,7268,86.79141441937259,13.208585580627409,-0.23219253415316388,1.5256984431648357
OKLAHOMA,OK,BLAINE,40011,3901,688,3136,3824,82.00836820083683,17.99163179916318,3793,711,2884,3595,80.22253129346315,19.777468706536858,2.226103911930788,-9.029653561193207
OKLAHOMA,OK,BRYAN,40013,15976,3323,12344,15667,78.7898129827025,21.210187017297503,13818,2804,10478,13282,78.88872157807559,21.11127842192441,-0.12537735863192845,0.46851068607183244
OKLAHOMA,OK,CADDO,40015,9859,2670,7013,9683,72.42590106371992,27.574098936280077,9348,2420,6482,8902,72.815097730847,27.184902269153,-0.5344999584642518,1.4316647647790282
OKLAHOMA,OK,CANADIAN,40017,61940,16742,43550,60292,72.23180521462217,27.768194785377826,55278,11674,39986,51660,77.40224545102593,22.597754548974063,-6.679961551858615,22.88032744668651
OKLAHOMA,OK,CARTER,40019,19479,4470,14699,19169,76.68109969221138,23.318900307788617,18534,4002,13752,17754,77.45860087867523,22.541399121324773,-1.0037635299941283,3.4492144089153243
OKLAHOMA,OK,CHEROKEE,40021,17714,6027,11223,17250,65.06086956521739,34.93913043478261,16490,5456,9994,15450,64.68608414239482,35.31391585760518,0.5793911129286178,-1.0612966976922045
OKLAHOMA,OK,CHOCTAW,40023,5832,1082,4698,5780,81.280276816609,18.719723183391004,5426,1067,4206,5273,79.76483974966813,20.23516025033188,1.8998810399380117,-7.489128073082696
OKLAHOMA,OK,CIMARRON,40025,1054,70,970,1040,93.26923076923077,6.730769230769231,1079,71,963,1034,93.13346228239845,6.866537717601547,0.14577841680645243,-1.9772481040086665
OKLAHOMA,OK,CLEVELAND,40027,119778,49827,66677,116504,57.231511364416676,42.768488635583324,109450,38829,62538,101367,61.694634348456596,38.305365651543404,-7.234215797166121,11.65143031041682
OKLAHOMA,OK,COAL,40029,2524,374,2091,2465,84.82758620689656,15.172413793103448,2399,411,1898,2309,82.20008661758337,17.79991338241663,3.1964681515933346,-14.761305478647536
OKLAHOMA,OK,COMANCHE,40031,35631,13747,20905,34652,60.32840817268845,39.67159182731155,32564,11463,19183,30646,62.595444756248774,37.404555243751226,-3.6217277349627097,6.0608569431902515
OKLAHOMA,OK,COTTON,40033,2572,393,2117,2510,84.34262948207171,15.657370517928287,2602,424,2054,2478,82.88942695722356,17.110573042776434,1.7531820139112586,-8.493009095692706
OKLAHOMA,OK,CRAIG,40035,6032,1217,4686,5903,79.38336439098764,20.616635609012366,5785,1252,4283,5535,77.3803071364047,22.619692863595304,2.5885878832866194,-8.855368933000452
OKLAHOMA,OK,CREEK,40037,30505,6577,23294,29871,77.98198922031402,22.018010779685984,28830,5841,21575,27416,78.69492267289174,21.305077327108258,-0.9059459344551879,3.3463077445421874
OKLAHOMA,OK,CUSTER,40039,10691,2369,8060,10429,77.28449515773325,22.715504842266757,10541,2104,7826,9930,78.81168177240684,21.18831822759315,-1.937766813660724,7.207682074006128
OKLAHOMA,OK,DELAWARE,40041,17245,3472,13557,17029,79.61125139467967,20.388748605320338,15716,3311,11826,15137,78.1264451344388,21.873554865561207,1.9005168578780651,-6.78813420757054
OKLAHOMA,OK,DEWEY,40043,2359,214,2124,2338,90.84687767322498,9.153122326775021,2248,222,1965,2187,89.84910836762688,10.150891632373114,1.1104943874519213,-9.829375997040668
OKLAHOMA,OK,ELLIS,40045,1873,162,1688,1850,91.24324324324324,8.756756756756756,1827,155,1611,1766,91.22310305775764,8.776896942242356,0.02207794386566153,-0.2294681778552854
OKLAHOMA,OK,GARFIELD,40047,22430,4919,16970,21889,77.52752524098862,22.472474759011376,21710,4397,16009,20406,78.45241595609134,21.547584043908653,-1.1789193536377085,4.292317473819907
OKLAHOMA,OK,GARVIN,40049,10922,1865,8878,10743,82.63985851251978,17.36014148748022,10546,1855,8253,10108,81.64819944598338,18.35180055401662,1.2145510535017445,-5.40360638520212
OKLAHOMA,OK,GRADY,40051,23101,4144,18538,22682,81.7300061722952,18.269993827704788,22286,3882,17316,21198,81.68695159920748,18.31304840079253,0.05270679373490239,-0.23510325613445016
OKLAHOMA,OK,GRANT,40053,2226,280,1916,2196,87.2495446265938,12.750455373406194,2201,288,1827,2115,86.38297872340425,13.617021276595745,1.003167424874607,-6.363843351548271
OKLAHOMA,OK,GREER,40055,1973,328,1605,1933,83.03155716502846,16.968442834971547,1896,323,1482,1805,82.10526315789474,17.894736842105264,1.1281785984320836,-5.176348863394297
OKLAHOMA,OK,HARMON,40057,933,177,747,924,80.84415584415585,19.155844155844157,977,225,715,940,76.06382978723404,23.93617021276596,6.284624466442668,-19.971139971139973
OKLAHOMA,OK,HARPER,40059,1487,136,1327,1463,90.70403280929597,9.295967190704033,1499,134,1318,1452,90.77134986225896,9.228650137741047,-0.07416112359807103,0.7294355291213028
OKLAHOMA,OK,HASKELL,40061,5014,783,4165,4948,84.17542441390461,15.824575586095392,4738,882,3701,4583,80.75496399738162,19.245036002618374,4.2356039148675695,-17.77320871760184
OKLAHOMA,OK,HUGHES,40063,4857,919,3875,4794,80.83020442219441,19.16979557780559,4526,961,3388,4349,77.90296619912624,22.097033800873763,3.757543988230072,-13.247199825310595
OKLAHOMA,OK,JACKSON,40065,8221,1646,6392,8038,79.52226922119931,20.477730778800698,7806,1473,5969,7442,80.20693361999463,19.793066380005374,-0.853622458675618,3.4591123257534218
OKLAHOMA,OK,JEFFERSON,40067,2385,319,2026,2345,86.39658848614073,13.603411513859275,2350,365,1910,2275,83.95604395604396,16.043956043956044,2.906931312026262,-15.211613167041504
OKLAHOMA,OK,JOHNSTON,40069,4251,738,3441,4179,82.3402727925341,17.659727207465902,4018,786,3093,3879,79.7370456303171,20.26295436968291,3.2647650055737776,-12.847224124986978
OKLAHOMA,OK,KAY,40071,17249,4040,12834,16874,76.05784046462013,23.942159535379876,16803,3738,12172,15910,76.50534255185418,23.49465744814582,-0.5849291988082372,1.9046972198752954
OKLAHOMA,OK,KINGFISHER,40073,6465,854,5521,6375,86.60392156862746,13.39607843137255,6131,786,5156,5942,86.77213059575901,13.227869404240996,-0.19385144282694222,1.2716260040912086
OKLAHOMA,OK,KIOWA,40075,3427,699,2673,3372,79.27046263345196,20.729537366548044,3493,767,2596,3363,77.19298245614036,22.80701754385965,2.691281138790025,-9.108951546673971
OKLAHOMA,OK,LATIMER,40077,4249,762,3437,4199,81.85282210050012,18.14717789949988,4056,797,3100,3897,79.54837054144214,20.451629458557864,2.8969186211770914,-11.26781395940899
OKLAHOMA,OK,LE FLORE,40079,18805,3299,15213,18512,82.17912705272256,17.82087294727744,17221,3250,13362,16612,80.43582952082832,19.564170479171683,2.16731466844986,-8.9106641845622
OKLAHOMA,OK,LINCOLN,40081,14888,2609,12013,14622,82.1570236629736,17.8429763370264,14025,2430,10854,13284,81.70731707317073,18.29268292682927,0.5503871696094897,-2.4583960242556824
OKLAHOMA,OK,LOGAN,40083,21574,5455,15608,21063,74.10150500878318,25.898494991216825,18979,4248,13633,17881,76.24293943291762,23.757060567082377,-2.808698667787579,9.01388628482771
OKLAHOMA,OK,LOVE,40085,4076,711,3305,4016,82.29581673306772,17.704183266932272,3789,735,2922,3657,79.90155865463494,20.098441345365053,2.9965098538085932,-11.912655500447189
OKLAHOMA,OK,MAJOR,40093,3467,320,3084,3404,90.59929494712104,9.400705052878966,3407,310,2948,3258,90.48496009821977,9.515039901780233,0.12635784861612098,-1.2016223797429948
OKLAHOMA,OK,MARSHALL,40095,6064,1100,4891,5991,81.63912535469872,18.360874645301287,5492,1096,4206,5302,79.32855526216522,20.67144473783478,2.9126587329083575,-11.177593641069873
OKLAHOMA,OK,MAYES,40097,16626,3581,12749,16330,78.07103490508267,21.92896509491733,15717,3423,11555,14978,77.14648150620911,22.853518493790894,1.1984388410495983,-4.045562608334274
OKLAHOMA,OK,MCCLAIN,40087,19236,3582,15295,18877,81.02452720241564,18.975472797584363,16858,2894,13169,16063,81.98344020419597,18.01655979580402,-1.169642307509866,5.322397908637755
OKLAHOMA,OK,MCCURTAIN,40089,11467,1858,9485,11343,83.6198536542361,16.380146345763908,10726,1802,8656,10458,82.76917192579843,17.23082807420157,1.0277760531424596,-4.936975314096037
OKLAHOMA,OK,MCINTOSH,40091,8335,2031,6172,8203,75.24076557357064,24.759234426429355,7963,2123,5505,7628,72.16832721552176,27.831672784478236,4.2573223969476715,-11.039359300610862
OKLAHOMA,OK,MURRAY,40099,5894,1156,4612,5768,79.95839112343967,20.041608876560332,5528,1087,4175,5262,79.34245534017484,20.657544659825163,0.7763003812070846,-2.981650498196453
OKLAHOMA,OK,MUSKOGEE,40101,25081,8027,16526,24553,67.30745733718894,32.692542662811064,24216,7977,15043,23020,65.34752389226759,34.652476107732404,2.9992466863052236,-5.655969399785543
OKLAHOMA,OK,NOBLE,40103,4938,1003,3821,4824,79.208126036484245,20.791873963515755,4878,901,3715,4616,80.48093587521664,19.519064124783363,-1.5815047686645323,6.520854845270496
OKLAHOMA,OK,NOWATA,40105,4391,712,3610,4322,83.52614530310042,16.473854696899583,4237,742,3321,4063,81.73763229141029,18.26236770858971,2.1881145337238728,-9.793434456195405
OKLAHOMA,OK,OKFUSKEE,40107,4038,896,3058,3954,77.33940313606475,22.660596863935254,3943,943,2800,3743,74.80630510285867,25.19369489714133,3.3862092636751218,-10.054491981219883
OKLAHOMA,OK,OKLAHOMA,40109,294740,141724,145050,286774,50.579899154037676,49.420100845962324,273942,112813,141569,254382,55.65212947456974,44.34787052543026,-9.114171134906568,11.4373706345686
OKLAHOMA,OK,OKMULGEE,40111,14313,4357,9668,14025,68.93404634581105,31.06595365418895,13949,4385,8944,13329,67.10180808762848,32.89819191237152,2.73053485502186,-5.569419325727598
OKLAHOMA,OK,OSAGE,40113,20538,6002,14121,20123,70.17343338468419,29.82656661531581,18966,5597,12577,18174,69.20325740068229,30.796742599317707,1.4019224245249706,-3.1502551962212744
OKLAHOMA,OK,OTTAWA,40115,11438,2686,8545,11231,76.08405306740272,23.915946932597276,10690,2584,7631,10215,74.70386686245718,25.296133137542828,1.8475431900824013,-5.456115357398927
OKLAHOMA,OK,PAWNEE,40117,6786,1363,5267,6630,79.4419306184012,20.558069381598795,6364,1344,4729,6073,77.86925736868105,22.130742631318952,2.019633039871116,-7.106283218415566
OKLAHOMA,OK,PAYNE,40119,29643,10904,17813,28717,62.02945990180033,37.97054009819967,27760,8788,16651,25439,65.454616926766,34.545383073234014,-5.2328730741758145,9.91494874352541
OKLAHOMA,OK,PITTSBURG,40121,17924,3768,13851,17619,78.61399625404393,21.38600374595607,17271,3711,12753,16464,77.45991253644316,22.54008746355685,1.489910948528106,-5.120138595143963
OKLAHOMA,OK,PONTOTOC,40123,15320,4117,10805,14922,72.40986462940624,27.590135370593753,14831,3637,10431,14068,74.14700028433325,25.852999715666762,-2.3428266123586505,6.719280834070096
OKLAHOMA,OK,POTTAWATOMIE,40125,28185,7275,20240,27515,73.55987643103762,26.440123568962385,25452,6015,17848,23863,74.79361354398021,25.20638645601978,-1.6495220039303593,4.8945417666083735
OKLAHOMA,OK,PUSHMATAHA,40127,4739,668,4016,4684,85.73868488471392,14.26131511528608,4483,748,3581,4329,82.72118272118271,17.27881727881728,3.6477986221520764,-17.463592066746735
OKLAHOMA,OK,ROGER MILLS,40129,1834,168,1629,1797,90.65108514190317,9.348914858096828,1759,151,1547,1698,91.10718492343933,8.892815076560659,-0.5006188940196554,5.128857146015986
OKLAHOMA,OK,ROGERS,40131,44553,9589,34031,43620,78.01696469509399,21.983035304906007,40862,7902,30913,38815,79.64189102151231,20.3581089784877,-2.040290989548965,7.981715434058034
OKLAHOMA,OK,SEMINOLE,40133,8337,2150,6011,8161,73.65518931503492,26.34481068496508,8037,2071,5613,7684,73.0478917230609,26.952108276939093,0.8313690890305203,-2.253247077126186
OKLAHOMA,OK,SEQUOYAH,40135,15386,3035,12113,15148,79.96435172960126,20.03564827039873,14437,3061,10888,13949,78.05577460749875,21.944225392501256,2.4451453229434206,-8.69740028624898
OKLAHOMA,OK,STEPHENS,40137,19057,3154,15560,18714,83.14630757721491,16.85369242278508,17904,3086,14182,17268,82.12879314338662,17.871206856613387,1.2389253450392657,-5.693596643988075
OKLAHOMA,OK,TEXAS,40139,5521,894,4505,5399,83.44137803296907,16.55862196703093,5780,858,4621,5479,84.34020806716553,15.659791932834459,-1.0657194887172539,5.7397316519376185
OKLAHOMA,OK,TILLMAN,40141,2708,597,2076,2673,77.665544332211,22.334455667789,2706,657,1944,2601,74.74048442906575,25.259515570934255,3.9136218148563717,-11.580031671355872
OKLAHOMA,OK,TULSA,40143,266678,108996,150574,259570,58.00901490927303,41.99098509072697,247054,87847,144258,232105,62.15204325628487,37.84795674371513,-6.665956789108285,10.94650465563063
OKLAHOMA,OK,WAGONER,40145,35338,8464,26165,34629,75.55805827485634,24.441941725143664,31300,6723,23005,29728,77.3849569429494,22.615043057050592,-2.360793027823105,8.078245367406044
OKLAHOMA,OK,WASHINGTON,40147,23501,5790,17076,22866,74.67856205720284,25.321437942797168,22224,5048,15825,20873,75.81564700809659,24.184352991903417,-1.4998024758297146,4.701738149763335
OKLAHOMA,OK,WASHITA,40149,4777,598,4086,4684,87.2331340734415,12.766865926558497,4631,588,3854,4442,86.76271949572265,13.237280504277352,0.542185146400409,-3.5537101262366644
OKLAHOMA,OK,WOODS,40151,3678,591,2993,3584,83.51004464285714,16.489955357142858,3668,522,2947,3469,84.95243586047853,15.047564139521477,-1.697880941272012,9.585546233579635
OKLAHOMA,OK,WOODWARD,40153,7785,1005,6611,7616,86.80409663865547,13.195903361344538,7595,873,6347,7220,87.90858725761773,12.091412742382271,-1.25640810917087,9.134504317190807
OREGON,OR,BAKER,41001,9932,2346,7352,9698,75.80944524644256,24.190554753557436,8779,1797,6218,8015,77.57953836556456,22.420461634435433,-2.2816494612034055,7.8949896214595805
OREGON,OR,BENTON,41003,52799,35827,14878,50705,29.34227393748151,70.65772606251849,48753,29193,13445,42638,31.532904920493458,68.46709507950655,-6.947127099565886,3.1995383774762187
OREGON,OR,CLACKAMAS,41005,257679,139043,110509,249552,44.28295505545938,55.71704494454062,214039,102095,88392,190487,46.4031666202943,53.5968333797057,-4.569109651899595,3.955852297866791
OREGON,OR,CLATSOP,41007,23910,12916,10218,23134,44.168755943632746,55.831244056367254,19664,9252,8138,17390,46.79700977573318,53.20299022426682,-5.616285836842783,4.940049085627596
OREGON,OR,COLUMBIA,41009,32221,13835,17150,30985,55.349362594803935,44.650637405196065,26618,10167,13217,23384,56.52155319876839,43.47844680123161,-2.0738825060985677,2.6960268597526094
OREGON,OR,COOS,41011,37075,14243,21829,36072,60.51508094921269,39.48491905078731,31313,10448,17865,28313,63.098223430932784,36.901776569067216,-4.093843441642376,7.000049108436168
OREGON,OR,CROOK,41013,15448,3801,11287,15088,74.80779427359491,25.19220572640509,12172,2637,8511,11148,76.34553283100108,23.654467168998924,-2.0141827561936276,6.500837860433806
OREGON,OR,CURRY,41015,14925,6058,8484,14542,58.341356072067114,41.658643927932886,12611,4300,7212,11512,62.647671994440586,37.352328005559414,-6.873864239928373,11.52890904613102
OREGON,OR,DESCHUTES,41017,125234,65962,55646,121608,45.75850273008355,54.24149726991645,98557,42444,45692,88136,51.84260688027594,48.15739311972406,-11.73572186337557,12.63379048584856
OREGON,OR,DOUGLAS,41019,64349,19160,43298,62458,69.32338531493163,30.676614685068365,53521,14096,34582,48678,71.04235999835655,28.95764000164345,-2.419647494065069,5.936169809857983
OREGON,OR,GILLIAM,41021,1178,324,834,1158,72.02072538860104,27.979274611398964,1019,239,671,910,73.73626373626374,26.263736263736263,-2.326587028871918,6.53196609361113
OREGON,OR,GRANT,41023,4596,929,3545,4474,79.2355833705856,20.764416629414395,4340,739,3210,3949,81.28640162066345,18.713598379336542,-2.5229536665287933,10.958973301160269
OREGON,OR,HARNEY,41025,4481,894,3475,4369,79.5376516365301,20.4623483634699,3974,683,2912,3595,81.00139082058415,18.998609179415855,-1.8070543841601339,7.704454416799833
OREGON,OR,HOOD RIVER,41027,13090,8764,3955,12719,31.09521188772702,68.90478811227298,10910,6510,3272,9782,33.44919239419342,66.55080760580658,-7.037480841764754,3.537117867012962
OREGON,OR,JACKSON,41029,127165,59478,63869,123347,51.779937898773376,48.220062101226624,109327,44447,53870,98317,54.79215191675905,45.20784808324095,-5.497528227330573,6.663033401721097
OREGON,OR,JEFFERSON,41031,11913,4393,7189,11582,62.07045415299603,37.92954584700397,9459,2980,5483,8463,64.78790027177124,35.21209972822876,-4.19437288039296,7.717364598387455
OREGON,OR,JOSEPHINE,41033,51641,18451,31751,50202,63.24648420381658,36.75351579618342,44560,13453,26923,40376,66.68070140677631,33.3192985932237,-5.150241569910563,10.306991287200006
OREGON,OR,KLAMATH,41035,36726,10388,25308,35696,70.89870013446885,29.101299865531153,30507,7210,20435,27645,73.91933441852053,26.080665581479472,-4.086392697950025,11.58189109328831
OREGON,OR,LAKE,41037,4363,792,3470,4262,81.41717503519475,18.582824964805255,3930,639,3022,3661,82.54575252663207,17.454247473367932,-1.3672144924394614,6.465918929815406
OREGON,OR,LANE,41039,222253,134366,80336,214702,37.41744371268083,62.58255628731917,191950,102753,67141,169894,39.519347357764254,60.480652642235746,-5.318669931603692,3.4753322810799014
OREGON,OR,LINCOLN,41041,30726,17385,12460,29845,41.74903668956274,58.25096331043726,25256,12501,10039,22540,44.53859804791482,55.46140195208518,-6.26324464759993,5.029734662607455
OREGON,OR,LINN,41043,72640,26512,43486,69998,62.12463213234664,37.87536786765336,58719,17995,33488,51483,65.04671444942991,34.953285550570094,-4.492282726063013,8.359964652981255
OREGON,OR,MALHEUR,41045,11804,3260,8187,11447,71.52092251244868,28.479077487551322,10435,2246,7194,9440,76.20762711864407,23.79237288135593,-6.1499154131893885,19.698348834587943
OREGON,OR,MARION,41047,165534,80872,79002,159874,49.41516444199807,50.58483555800193,136840,57788,63377,121165,52.306359097099,47.693640902901,-5.527424781629042,6.062012881312784
OREGON,OR,MORROW,41049,5118,1371,3586,4957,72.34214242485375,27.65785757514626,4167,1017,2721,3738,72.79293739967898,27.207062600321027,-0.6192839455702703,1.6569042437529102
OREGON,OR,MULTNOMAH,41051,463659,367249,82995,450244,18.43333836764066,81.56666163235934,399103,292561,67954,360515,18.849146360068236,81.15085363993177,-2.205977843688789,0.5123889321885899
OREGON,OR,POLK,41053,48291,22917,23732,46649,50.87354498488713,49.12645501511287,40295,16420,18940,35360,53.56334841628959,46.43665158371041,-5.021723829693292,5.7924146975877555
OREGON,OR,SHERMAN,41055,1208,260,921,1181,77.98475867908552,22.01524132091448,1017,202,732,934,78.37259100642399,21.62740899357602,-0.49485709526521093,1.7932445234362548
OREGON,OR,TILLAMOOK,41057,16888,8066,8354,16420,50.87697929354446,49.12302070645554,13803,5768,6538,12306,53.12855517633675,46.87144482366325,-4.237976875748228,4.803726215957327
OREGON,OR,UMATILLA,41059,33038,10707,21270,31977,66.5165587766207,33.4834412233793,27597,7673,17059,24732,68.97541646449943,31.024583535500565,-3.564831955953862,7.925513923708705
OREGON,OR,UNION,41061,14944,4254,10298,14552,70.76690489279824,29.23309510720176,12968,3249,8431,11680,72.1832191780822,27.81678082191781,-1.9621101710493027,5.0915822875089445
OREGON,OR,WALLOWA,41063,5149,1625,3404,5029,67.68741300457347,32.31258699542653,4366,1116,2848,3964,71.84661957618567,28.15338042381433,-5.789008023128783,14.773382481963049
OREGON,OR,WASCO,41065,14130,6604,7035,13639,51.58002786128015,48.41997213871985,11964,4781,5833,10614,54.955718861880534,45.044281138119466,-6.142565451803961,7.4941611128158225
OREGON,OR,WASHINGTON,41067,320326,209940,99073,309013,32.06111069760819,67.93888930239181,269232,153251,83197,236448,35.18617201245094,64.81382798754906,-8.881504113993744,4.8215965818946716
OREGON,OR,WHEELER,41069,965,217,711,928,76.61637931034483,23.38362068965517,818,155,591,746,79.22252010723861,20.777479892761395,-3.289646420444603,12.54310344827585
OREGON,OR,YAMHILL,41071,58923,27174,29551,56725,52.09519612163949,47.90480387836051,48753,19301,23250,42551,54.64031397616977,45.35968602383023,-4.657948809811529,5.610968852811671
PENNSYLVANIA,PA,ADAMS,42001,56540,18207,37523,55730,67.32998385070877,32.67001614929123,47489,14219,31423,45642,68.8466763069103,31.1533236930897,-2.203000257325849,4.8684771844679675
PENNSYLVANIA,PA,ALLEGHENY,42003,719733,429065,282324,711389,39.686303836578865,60.313696163421135,650114,367617,259480,627097,41.37796863962035,58.62203136037965,-4.08832250267036,2.8857150866061776
PENNSYLVANIA,PA,ARMSTRONG,42005,36370,8457,27489,35946,76.47304289767985,23.526957102320146,31618,7178,23484,30662,76.58991585676081,23.41008414323919,-0.15259575333591568,0.4992419436250062
PENNSYLVANIA,PA,BEAVER,42007,94122,38122,54759,92881,58.95608359083128,41.04391640916872,83571,32531,48167,80698,59.68797244045701,40.31202755954299,-1.22619150844141,1.8155595089944132
PENNSYLVANIA,PA,BEDFORD,42009,27574,4367,23025,27392,84.0573890186916,15.94261098130841,23637,3645,19552,23197,84.28676121912316,15.713238780876837,-0.2721331287546591,1.4597385276848396
PENNSYLVANIA,PA,BERKS,42011,205540,92895,109736,202631,54.155583301666574,45.844416698333426,183065,78437,96626,175063,55.194986947556025,44.805013052443975,-1.8831486397071662,2.319837837504557
PENNSYLVANIA,PA,BLAIR,42013,63595,17636,45306,62942,71.9805535254679,28.01944647453211,54909,13958,39135,53093,73.71028195807357,26.28971804192643,-2.346658277049518,6.579486435902937
PENNSYLVANIA,PA,BRADFORD,42015,30159,8046,21600,29646,72.85974499089254,27.140255009107467,25708,6369,18141,24510,74.01468788249694,25.98531211750306,-1.5604239167203549,4.4445988810212
PENNSYLVANIA,PA,BUCKS,42017,396234,204712,187367,392079,47.78807332195807,52.21192667804193,344297,167060,164361,331421,49.592813973767505,50.407186026232495,-3.639117257520541,3.580324144399216
PENNSYLVANIA,PA,BUTLER,42019,113305,37508,74359,111867,66.4708984776565,33.529101522343495,97071,28584,64428,93012,69.26848148625984,30.731518513740163,-4.038753194204602,9.103302224888509
PENNSYLVANIA,PA,CAMBRIA,42021,70574,21730,48085,69815,68.87488362099835,31.125116379001646,63072,18867,42258,61125,69.13374233128835,30.866257668711658,-0.3744317920033158,0.8386462429891051
PENNSYLVANIA,PA,CAMERON,42023,2434,634,1771,2405,73.63825363825364,26.361746361746363,2186,531,1589,2120,74.95283018867924,25.047169811320753,-1.7538717979246554,5.248403553488301
PENNSYLVANIA,PA,CARBON,42025,33629,11212,21984,33196,66.22484636703217,33.77515363296783,28776,8936,18743,27679,67.71559666172911,32.28440333827089,-2.201487350313003,4.617555663262807
PENNSYLVANIA,PA,CENTRE,42027,77493,40055,36372,76427,47.590511206772476,52.409488793227524,76148,37088,35274,72362,48.7465796965258,51.2534203034742,-2.371588933932356,2.2555928617215892
PENNSYLVANIA,PA,CHESTER,42029,314502,182372,128565,310937,41.34760417705194,58.65239582294806,268800,141682,116114,257796,45.04104020233053,54.95895979766947,-8.200157031647503,6.720352857615786
PENNSYLVANIA,PA,CLARION,42031,19493,4678,14578,19256,75.70627336933943,24.293726630660572,17535,4273,12576,16849,74.63944447741706,25.360555522582942,1.42930979643765,-4.206646384273349
PENNSYLVANIA,PA,CLEARFIELD,42033,39422,9673,29203,38876,75.11832493054841,24.88167506945159,34271,8200,24932,33132,75.25051309911868,24.749486900881323,-0.17566414251043438,0.5341046830573237
PENNSYLVANIA,PA,CLINTON,42035,17625,5502,11902,17404,68.38657779820731,31.61342220179269,15394,4744,10022,14766,67.87213869700663,32.12786130299337,0.7579532796177624,-1.6012242344707328
PENNSYLVANIA,PA,COLUMBIA,42037,31171,10532,20098,30630,65.61540972902384,34.38459027097617,28228,8934,18004,26938,66.83495433959463,33.165045660405376,-1.8247107709151278,3.6771986478123964
PENNSYLVANIA,PA,CRAWFORD,42039,42004,12924,28559,41483,68.84506906443603,31.154930935563964,37492,10971,24987,35958,69.48940430502253,30.510595694977475,-0.9272424293036097,2.111840906116935
PENNSYLVANIA,PA,CUMBERLAND,42041,141595,62245,77212,139457,55.36617021734298,44.63382978265702,121617,47085,69076,116161,59.465741513933246,40.534258486066754,-6.8940051737683365,10.113843079180661
PENNSYLVANIA,PA,DAUPHIN,42043,147368,78983,66408,145391,45.675454464169036,54.324545535830964,130872,64706,60863,125569,48.469765626866504,51.530234373133496,-5.765060190735893,5.422663406620076
PENNSYLVANIA,PA,DELAWARE,42045,327931,206423,118532,324955,36.47643519871982,63.52356480128018,297634,177402,110667,288069,38.41683763265051,61.58316236734949,-5.0509166123594245,3.150865202985198
PENNSYLVANIA,PA,ELK,42047,16906,4522,12140,16662,72.86040091225543,27.139599087744568,14426,3853,10025,13878,72.23663352068021,27.763366479319785,0.8635056219731485,-2.2467282274282074
PENNSYLVANIA,PA,ERIE,42049,137083,68286,66869,135155,49.475787059302284,50.524212940697716,123679,58112,60069,118181,50.82796727054264,49.17203272945736,-2.660307472150314,2.7498969153461728
PENNSYLVANIA,PA,FAYETTE,42051,62139,20444,41227,61671,66.84989703426245,33.150102965737545,53767,17946,34590,52536,65.84056646870717,34.15943353129283,1.532991922290039,-2.954763768639934
PENNSYLVANIA,PA,FOREST,42053,2646,728,1882,2610,72.10727969348659,27.89272030651341,2401,626,1683,2309,72.8886964053703,27.11130359462971,-1.0720684419129434,2.88225429351352
PENNSYLVANIA,PA,FRANKLIN,42055,80783,22422,57245,79667,71.8553478855737,28.1446521144263,69731,17465,49768,67233,74.02317314414053,25.976826855859475,-2.9285765071777714,8.345227346648908
PENNSYLVANIA,PA,FULTON,42057,7977,1085,6824,7909,86.2814515109369,13.718548489063092,6771,912,5694,6606,86.19436875567666,13.805631244323342,0.10103067812594624,-0.6307770627732578
PENNSYLVANIA,PA,GREENE,42059,17669,4911,12579,17490,71.92109777015438,28.078902229845625,15764,4482,10849,15331,70.7651164307612,29.234883569238796,1.633546862774149,-3.9541164467284062
PENNSYLVANIA,PA,HUNTINGDON,42061,22792,5445,17061,22506,75.80645161290323,24.193548387096776,19706,4539,14494,19033,76.1519466190301,23.848053380969894,-0.45369162768129634,1.4487346225188213
PENNSYLVANIA,PA,INDIANA,42063,41198,12634,28089,40723,68.97576308228766,31.02423691771235,37770,11528,24888,36416,68.34358523725835,31.65641476274165,0.924999534096238,-1.996997606227191
PENNSYLVANIA,PA,JEFFERSON,42065,22824,4527,17960,22487,79.86836839062569,20.131631609374306,19478,3650,15192,18842,80.62838339878994,19.371616601210064,-0.9426147172084454,3.9233432284467407
PENNSYLVANIA,PA,JUNIATA,42067,12043,2253,9649,11902,81.07040833473366,18.92959166526634,10454,1821,8273,10094,81.95957994848425,18.040420051515753,-1.0848903987910608,4.928774447665263
PENNSYLVANIA,PA,LACKAWANNA,42069,115410,61991,52334,114325,45.7765143232014,54.2234856767986,103456,51983,48384,100367,48.20708001634003,51.79291998365997,-5.041926813063102,4.692853181294754
PENNSYLVANIA,PA,LANCASTER,42071,280239,115847,160209,276056,58.034963920363985,41.965036079636015,241112,91093,137914,229007,60.222613282563415,39.777386717436585,-3.6326045034529075,5.499731236090644
PENNSYLVANIA,PA,LAWRENCE,42073,46076,15978,29597,45575,64.94130554031815,35.058694459681846,40753,14009,25428,39437,64.47752110961787,35.522478890382125,0.7192963108985095,-1.3056082942056513
PENNSYLVANIA,PA,LEBANON,42075,71652,23932,46731,70663,66.13220497289954,33.86779502710046,61845,18953,40525,59478,68.13443626214735,31.86556373785265,-2.9386480597626385,6.2833700533889925
PENNSYLVANIA,PA,LEHIGH,42077,184713,98288,84259,182547,46.15742795006218,53.84257204993782,160993,81324,73690,155014,47.537641761389295,52.462358238610705,-2.903412454187293,2.630864981420755
PENNSYLVANIA,PA,LUZERNE,42079,153321,64873,86929,151802,57.264726419941766,42.735273580058234,134983,52451,78688,131139,60.003507728440816,39.996492271559184,-4.564368671401697,6.847553755224056
PENNSYLVANIA,PA,LYCOMING,42081,59254,16971,41462,58433,70.95648007119264,29.043519928807353,50565,13020,35627,48647,73.23575965629946,26.764240343700536,-3.11224952919672,8.516137786228217
PENNSYLVANIA,PA,MCKEAN,42083,19466,5098,14083,19181,73.42161513998228,26.578384860017724,16296,4025,11635,15660,74.29757343550448,25.70242656449553,-1.1789864123659344,3.4080762504043793
PENNSYLVANIA,PA,MERCER,42085,57954,21067,36143,57210,63.1760181786401,36.8239818213599,52309,18733,31544,50277,62.74041808381566,37.25958191618434,0.6942894359462493,-1.1690954981843915
PENNSYLVANIA,PA,MIFFLIN,42087,21502,4603,16670,21273,78.36224321910403,21.63775678089597,18601,3877,14094,17971,78.42635356963997,21.573646430360025,-0.08174592801769576,0.2971697470934842
PENNSYLVANIA,PA,MONROE,42089,83829,44060,38726,82786,46.77844079916894,53.22155920083106,69752,33918,33386,67304,49.6047783192678,50.3952216807322,-5.697712228261354,5.608344255343289
PENNSYLVANIA,PA,MONTGOMERY,42091,510157,319511,185460,504971,36.72686154254403,63.27313845745597,434687,256082,162731,418813,38.8552886371722,61.1447113628278,-5.477831124877919,3.4809667871326777
PENNSYLVANIA,PA,MONTOUR,42093,9771,3771,5844,9615,60.78003120124805,39.21996879875195,8556,2857,5288,8145,64.92326580724371,35.07673419275629,-6.381740897472509,11.811916648874575
PENNSYLVANIA,PA,NORTHAMPTON,42095,170942,85087,83854,168941,49.635079702381304,50.364920297618696,143519,66272,71736,138008,51.979595385774736,48.020404614225264,-4.5104538925192506,4.882332213208596
PENNSYLVANIA,PA,NORTHUMBERLAND,42097,42283,12677,28952,41629,69.54767109466958,30.45232890533042,36622,9788,25427,35215,72.20502626721567,27.794973732784324,-3.6802911236563762,9.56056011454951
PENNSYLVANIA,PA,PERRY,42099,24652,5950,18293,24243,75.45683290021861,24.543167099781382,21158,4632,15616,20248,77.12366653496642,22.876333465033582,-2.1612479147267827,7.286279671065077
PENNSYLVANIA,PA,PHILADELPHIA,42101,741377,603790,132740,736530,18.022348037418706,81.97765196258129,707631,584025,108748,692773,15.697493984320982,84.30250601567901,14.810351610389795,-2.7577520087781693
PENNSYLVANIA,PA,PIKE,42103,32554,13019,19213,32232,59.60846363862,40.39153636138,26101,9256,16056,25312,63.43236409608091,36.56763590391909,-6.028311433685262,10.457062270878414
PENNSYLVANIA,PA,POTTER,42105,9064,1726,7239,8965,80.7473508087005,19.252649191299497,7784,1302,6251,7553,82.76181649675625,17.238183503243743,-2.434052046374191,11.686067082861062
PENNSYLVANIA,PA,SCHUYLKILL,42107,70603,20727,48871,69598,70.21897180953475,29.781028190465243,62869,16770,44001,60771,72.40460087870859,27.595399121291404,-3.0186328529525186,7.920266199329951
PENNSYLVANIA,PA,SNYDER,42109,19140,4910,13983,18893,74.01153866511406,25.988461334885937,16363,4002,11725,15727,74.55331595345584,25.44668404654416,-0.7266977751600123,2.129068319278149
PENNSYLVANIA,PA,SOMERSET,42111,40543,8654,31466,40120,78.4297108673978,21.570289132602195,35773,7376,27379,34755,78.77715436627824,21.222845633721768,-0.4410460134990135,1.6371202282523312
PENNSYLVANIA,PA,SULLIVAN,42113,3595,921,2619,3540,73.98305084745763,26.016949152542374,3136,750,2291,3041,75.33706017757316,24.662939822426832,-1.7972686044877006,5.490056497175155
PENNSYLVANIA,PA,SUSQUEHANNA,42115,21752,6236,15207,21443,70.91824837942453,29.081751620575478,18863,5123,12891,18014,71.56100810480737,28.43899189519263,-0.8981982540568256,2.260135407582786
PENNSYLVANIA,PA,TIOGA,42117,21075,4955,15742,20697,76.05933227037735,23.94066772962265,18325,3901,13614,17515,77.72766200399657,22.272337996003426,-2.1463783813971293,7.490590947024023
PENNSYLVANIA,PA,UNION,42119,20115,7475,12356,19831,62.30648983914074,37.69351016085926,17468,6180,10622,16802,63.21866444470896,36.78133555529104,-1.4428881305551977,2.479993159022209
PENNSYLVANIA,PA,VENANGO,42121,26528,7585,18569,26154,70.99870000764702,29.001299992352987,23348,6309,16021,22330,71.74652933273623,28.25347066726377,-1.042321255180212,2.6468582706042465
PENNSYLVANIA,PA,WARREN,42123,20650,6066,14237,20303,70.1226419740925,29.8773580259075,18434,5145,12477,17622,70.80354102826013,29.196458971739872,-0.9616737302670431,2.3321288887350633
PENNSYLVANIA,PA,WASHINGTON,42125,118478,45088,72080,117168,61.51850334562338,38.48149665437662,101450,36322,61386,97708,62.825971261309206,37.174028738690794,-2.081094632421576,3.5171542069773354
PENNSYLVANIA,PA,WAYNE,42127,28089,9191,18637,27828,66.97211441713382,33.027885582866176,24018,7008,16244,23252,69.86065714777223,30.139342852227767,-4.134720239645673,9.583960555480076
PENNSYLVANIA,PA,WESTMORELAND,42129,204697,72129,130218,202347,64.35380806238788,35.64619193761212,182051,59669,116522,176191,66.13391149377664,33.86608850622336,-2.691665124867537,5.256300653267476
PENNSYLVANIA,PA,WYOMING,42131,14858,4704,9936,14640,67.8688524590164,32.131147540983605,13144,3811,8837,12648,69.86875395319419,30.13124604680582,-2.862368914604585,6.637300996683448
PENNSYLVANIA,PA,YORK,42133,238471,88114,146733,234847,62.48025310095509,37.51974689904491,205986,68524,128528,197052,65.22542273105576,34.774577268944235,-4.208741799067884,7.89418548173777
RHODE ISLAND,RI,BRISTOL,44001,28415,18050,9745,27795,35.06026263716496,64.93973736283505,25475,14609,8965,23574,38.02918469500297,61.97081530499703,-7.806956898100747,4.790839112291967
RHODE ISLAND,RI,FEDERAL PRECINCT,NA,1374,1276,85,1361,6.245407788390889,93.75459221160911,NA,NA,NA,NA,NA,NA,NA,NA
RHODE ISLAND,RI,KENT,44003,93093,49113,42001,91114,46.0971969181465,53.9028030818535,82053,37788,38336,76124,50.35993904681835,49.64006095318165,-8.46454981748267,8.587302365910233
RHODE ISLAND,RI,NEWPORT,44005,46148,29486,15722,45208,34.77703061405061,65.22296938594938,41045,22851,15077,37928,39.75163467622864,60.24836532377136,-12.514212566842764,8.256828273173511
RHODE ISLAND,RI,PROVIDENCE,44007,272667,165012,102551,267563,38.32779569671442,61.67220430328558,248474,142899,90882,233781,38.87484440566171,61.12515559433829,-1.4072048835457762,0.8949649348589439
RHODE ISLAND,RI,WASHINGTON,44009,76060,44549,29818,74367,40.0957413906706,59.9042586093294,66369,33741,27230,60971,44.66057633957127,55.33942366042873,-10.22117339953812,8.248793801885634
SOUTH CAROLINA,SC,ABBEVILLE,45001,12433,4101,8215,12316,66.70185125040598,33.29814874959403,10775,3741,6763,10504,64.38499619192689,35.61500380807311,3.5984393810830184,-6.505278143347848
SOUTH CAROLINA,SC,AIKEN,45003,85185,32275,51589,83864,61.51507202136793,38.48492797863207,74851,25455,46025,71480,64.38864017907107,35.61135982092893,-4.462849579850536,8.069245802892189
SOUTH CAROLINA,SC,ALLENDALE,45005,3593,2718,835,3553,23.501266535322262,76.49873346467774,3592,2735,789,3524,22.38933030646992,77.61066969353008,4.966366629246721,-1.4327105193695289
SOUTH CAROLINA,SC,ANDERSON,45007,96093,27169,67565,94734,71.32075073363312,28.67924926636688,80483,21097,56232,77329,72.7178678115584,27.282132188441594,-1.9212844380225635,5.120996659187771
SOUTH CAROLINA,SC,BAMBERG,45009,6482,4010,2417,6427,37.60697059281158,62.39302940718842,6214,3898,2204,6102,36.119305145853815,63.880694854146185,4.118754336359465,-2.328818511374109
SOUTH CAROLINA,SC,BARNWELL,45011,10321,4720,5492,10212,53.77986682334508,46.22013317665492,9485,4400,4889,9289,52.63214554849822,47.36785445150178,2.1806469466255862,-2.4229961186482907
SOUTH CAROLINA,SC,BEAUFORT,45013,97835,43419,53194,96613,55.05884301284506,44.94115698715494,78524,32138,42922,75060,57.183586464162005,42.816413535837995,-3.7156526596116235,4.962450788967887
SOUTH CAROLINA,SC,BERKELEY,45015,104458,45223,57397,102620,55.931592282206196,44.068407717793804,79517,30705,44587,75292,59.21877490304415,40.78122509695585,-5.550912909326289,8.06052935639574
SOUTH CAROLINA,SC,CALHOUN,45017,8291,3905,4305,8210,52.43605359317905,47.56394640682095,7549,3573,3787,7360,51.453804347826086,48.546195652173914,1.9089924599413166,-2.0233289800721477
SOUTH CAROLINA,SC,CHARLESTON,45019,218857,121485,93297,214782,43.43799759756404,56.56200240243596,176345,89299,75443,164742,45.79463646186158,54.20536353813842,-5.146102352532445,4.347611952900987
SOUTH CAROLINA,SC,CHEROKEE,45021,25270,6983,18043,25026,72.09701910013585,27.90298089986414,21759,6092,15167,21259,71.34390140646315,28.656098593536854,1.055616077654653,-2.628123612900235
SOUTH CAROLINA,SC,CHESTER,45023,15757,6941,8660,15601,55.509262226780336,44.490737773219664,14192,6579,7265,13844,52.477607627853224,47.522392372146776,5.777044221272809,-6.379423357280278
SOUTH CAROLINA,SC,CHESTERFIELD,45025,18876,7431,11297,18728,60.321443827424176,39.678556172575824,16581,6858,9312,16170,57.58812615955473,42.41187384044527,4.74632159465731,-6.444699138152366
SOUTH CAROLINA,SC,CLARENDON,45027,16733,8250,8361,16611,50.33411594726386,49.66588405273614,15395,7732,7386,15118,48.85566873925122,51.14433126074878,3.026152841962504,-2.8907352419471177
SOUTH CAROLINA,SC,COLLETON,45029,19283,8602,10440,19042,54.82617372124777,45.17382627875223,17251,7627,9091,16718,54.378514176336886,45.621485823663114,0.8232287176130448,-0.9812471839281689
SOUTH CAROLINA,SC,DARLINGTON,45031,32417,15220,16832,32052,52.51466367153376,47.48533632846624,29674,13888,14989,28877,51.906361464141014,48.093638535858986,1.1719222658536532,-1.2648288337327451
SOUTH CAROLINA,SC,DILLON,45033,13101,6436,6582,13018,50.56076202181595,49.43923797818405,11698,5834,5637,11471,49.141312875948046,50.858687124051954,2.888504728091301,-2.790966944163642
SOUTH CAROLINA,SC,DORCHESTER,45035,77278,33824,41913,75737,55.340190395711474,44.659809604288526,62567,24055,34987,59042,59.257816469631784,40.742183530368216,-6.611154962025978,9.61565074439421
SOUTH CAROLINA,SC,EDGEFIELD,45037,13304,4953,8184,13137,62.2973281571135,37.7026718428865,11644,4491,6842,11333,60.37236389305568,39.62763610694432,3.1884858235263547,-4.857630818206915
SOUTH CAROLINA,SC,FAIRFIELD,45039,12136,7382,4625,12007,38.51919713500458,61.48080286499542,11267,6945,4027,10972,36.70251549398469,63.29748450601531,4.94974694940904,-2.8700692534586403
SOUTH CAROLINA,SC,FLORENCE,45041,64510,31153,32615,63768,51.1463429933509,48.8536570066491,57931,26710,29573,56283,52.543396762788056,47.456603237211944,-2.6588569744439683,2.943855383947258
SOUTH CAROLINA,SC,GEORGETOWN,45043,36668,15822,20487,36309,56.42402710071883,43.57597289928117,31657,13310,17389,30699,56.64353887748786,43.35646112251214,-0.3875318899897895,0.5062954196117575
SOUTH CAROLINA,SC,GREENVILLE,45045,258155,103030,150021,253051,59.28488723616979,40.71511276383021,215165,74483,127832,202315,63.184637817265155,36.815362182734845,-6.171991667300125,10.59272637802331
SOUTH CAROLINA,SC,GREENWOOD,45047,32006,12145,19431,31576,61.53724347605777,38.46275652394223,28763,10711,16961,27672,61.29300375831165,38.70699624168835,0.3984789499127839,-0.6309963093521276
SOUTH CAROLINA,SC,HAMPTON,45049,9305,5323,3906,9229,42.32311192978654,57.67688807021346,8806,5170,3488,8658,40.28644028644029,59.71355971355971,5.0554768027786245,-3.410735606981019
SOUTH CAROLINA,SC,HORRY,45051,179744,59180,118821,178001,66.75299576968669,33.247004230313316,132920,39410,89288,128698,69.37792351085487,30.62207648914513,-3.7835201867312818,8.572010921919905
SOUTH CAROLINA,SC,JASPER,45053,14394,7185,7078,14263,49.62490359671878,50.37509640328122,11427,5956,5187,11143,46.549403212779325,53.450596787220675,6.60695985699582,-5.7539121521553716
SOUTH CAROLINA,SC,KERSHAW,45055,33629,12699,20471,33170,61.71540548688574,38.28459451311426,28995,10330,17542,27872,62.93771526980482,37.06228473019518,-1.9420943033588212,3.2979882158296725
SOUTH CAROLINA,SC,LANCASTER,45057,49868,18937,30312,49249,61.54845783670734,38.45154216329266,38938,13812,23719,37531,63.19842263728651,36.80157736271349,-2.6107689586633898,4.48340782873855
SOUTH CAROLINA,SC,LAURENS,45059,30488,10159,20004,30163,66.31966316347844,33.68033683652157,26566,8889,16816,25705,65.41917914802568,34.58082085197432,1.3764832074936617,-2.603998381956696
SOUTH CAROLINA,SC,LEE,45061,8431,5329,3008,8337,36.08012474511215,63.91987525488785,8156,5199,2803,8002,35.02874281429643,64.97125718570358,3.0014834856894046,-1.618226237812559
SOUTH CAROLINA,SC,LEXINGTON,45063,144568,49301,92817,142118,65.30981297231878,34.690187027681226,122093,35230,80026,115256,69.4332616089401,30.5667383910599,-5.938722366011384,13.489985695782792
SOUTH CAROLINA,SC,MARION,45067,14704,8872,5711,14583,39.16203798943976,60.83796201056024,14276,8569,5444,14013,38.84963962035253,61.15036037964747,0.8041216653231764,-0.5108692199812581
SOUTH CAROLINA,SC,MARLBORO,45069,11446,6290,5044,11334,44.50326451385212,55.49673548614788,10389,5954,4267,10221,41.747382839252516,58.252617160747484,6.601328004706497,-4.730914779321893
SOUTH CAROLINA,SC,MCCORMICK,45065,5697,2687,2958,5645,52.400354295837026,47.599645704162974,5216,2479,2652,5131,51.68583122198402,48.31416877801598,1.3824351025413906,-1.4789100007824851
SOUTH CAROLINA,SC,NEWBERRY,45071,18631,6958,11443,18401,62.18683767186566,37.81316232813434,16807,6217,10017,16234,61.703831464826905,38.296168535173095,0.782781547875322,-1.2612389842475702
SOUTH CAROLINA,SC,OCONEE,45073,40668,10414,29698,40112,74.03769445552453,25.96230554447547,33635,7998,24178,32176,75.14296369965192,24.857036300348085,-1.4708885432642371,4.446504526011852
SOUTH CAROLINA,SC,ORANGEBURG,45075,41205,27295,13603,40898,33.260795148907036,66.73920485109296,38910,26318,11931,38249,31.192972365290597,68.8070276347094,6.629130303456976,-3.0052493977713035
SOUTH CAROLINA,SC,PICKENS,45077,57546,13645,42907,56552,75.8717640401754,24.128235959824586,49049,10354,36236,46590,77.7763468555484,22.2236531444516,-2.4487943859208383,8.570070829459864
SOUTH CAROLINA,SC,RICHLAND,45079,193822,132570,58313,190883,30.549079802811146,69.45092019718885,168722,108000,52469,160469,32.697281094790895,67.3027189052091,-6.569969184141078,3.1918491955805317
SOUTH CAROLINA,SC,SALUDA,45081,9274,2963,6210,9173,67.69868091137033,32.301319088629675,8564,2813,5526,8339,66.26693848183236,33.733061518167645,2.16056824464661,-4.24432993953684
SOUTH CAROLINA,SC,SPARTANBURG,45083,148655,52926,93560,146486,63.86958480673921,36.13041519326079,121090,39997,76277,116274,65.60108020709703,34.39891979290297,-2.6394312332840175,5.033574922649309
SOUTH CAROLINA,SC,SUMTER,45085,48920,27379,21000,48379,43.407263482089334,56.592736517910666,44086,24047,18745,42792,43.80491680687979,56.19508319312021,-0.9077823992762357,0.7076301024840248
SOUTH CAROLINA,SC,UNION,45087,13257,4935,8183,13118,62.37993596584845,37.62006403415155,12092,4729,7061,11790,59.88973706530958,40.11026293469042,4.157972672051158,-6.208383387048699
SOUTH CAROLINA,SC,WILLIAMSBURG,45089,15985,10289,5532,15821,34.96618418557613,65.03381581442386,15054,9953,4864,14817,32.82715799419586,67.17284200580414,6.516026126168084,-3.1843616073225833
SOUTH CAROLINA,SC,YORK,45091,144050,59008,82727,141735,58.3673757364095,41.6326242635905,114357,41593,66754,108347,61.61130442005778,38.38869557994222,-5.265151767493181,8.450218572529987
SOUTH DAKOTA,SD,AURORA,46003,1405,317,1052,1369,76.84441197954712,23.155588020452885,1407,340,974,1314,74.1248097412481,25.875190258751903,3.668950042222696,-10.510462768014438
SOUTH DAKOTA,SD,BEADLE,46005,7081,2107,4808,6915,69.53000723065799,30.46999276934201,6772,1912,4455,6367,69.97015863043819,30.029841369561804,-0.6290558838160654,1.4657133694563562
SOUTH DAKOTA,SD,BENNETT,46007,1183,466,694,1160,59.827586206896555,40.172413793103445,1149,412,666,1078,61.781076066790355,38.218923933209645,-3.1619550585067824,5.111315701372621
SOUTH DAKOTA,SD,BON HOMME,46009,3001,721,2235,2956,75.60893098782138,24.39106901217862,2974,704,2105,2809,74.937700249199,25.062299750800996,0.8957183585702078,-2.678248785213433
SOUTH DAKOTA,SD,BROOKINGS,46011,14567,6110,8000,14110,56.69737774627924,43.30262225372076,12680,4879,6748,11627,58.0373269114991,41.9626730885009,-2.3087713313591163,3.1931930608754655
SOUTH DAKOTA,SD,BROWN,46013,17547,6538,10580,17118,61.80628578104919,38.19371421895081,16114,5452,9613,15065,63.81015599070694,36.18984400929306,-3.1403624995832713,5.537106512929935
SOUTH DAKOTA,SD,BRULE,46015,2490,673,1750,2423,72.22451506397029,27.775484936029716,2288,571,1565,2136,73.26779026217228,26.732209737827716,-1.4239206539038096,3.9026897081601897
SOUTH DAKOTA,SD,BUFFALO,46017,549,352,183,535,34.205607476635514,65.79439252336448,490,296,171,467,36.61670235546038,63.38329764453962,-6.584686014100671,3.803990906794641
SOUTH DAKOTA,SD,BUTTE,46019,4802,939,3731,4670,79.89293361884368,20.10706638115632,4351,696,3357,4053,82.82753515914138,17.172464840858623,-3.54302652452384,17.08899431440598
SOUTH DAKOTA,SD,CAMPBELL,46021,873,117,747,864,86.45833333333333,13.541666666666666,831,105,704,809,87.02101359703337,12.978986402966626,-0.6466027462121215,4.335317460317456
SOUTH DAKOTA,SD,CHARLES MIX,46023,3783,1177,2552,3729,68.43657817109144,31.563421828908556,3433,935,2382,3317,71.81187820319566,28.188121796804342,-4.700197399869732,11.974192734213563
SOUTH DAKOTA,SD,CLARK,46025,1850,437,1373,1810,75.85635359116021,24.14364640883978,1657,398,1139,1537,74.10540013012361,25.894599869876384,2.3627879452267297,-6.7618479136011604
SOUTH DAKOTA,SD,CLAY,46027,5698,3083,2456,5539,44.34013359812241,55.65986640187759,5069,2608,2109,4717,44.71062115751537,55.28937884248463,-0.828634337437939,0.6700881202670983
SOUTH DAKOTA,SD,CODINGTON,46029,13161,3837,8958,12795,70.01172332942555,29.988276670574443,11669,3174,7764,10938,70.9818979703785,29.018102029621502,-1.3667916309561212,3.3433428553066413
SOUTH DAKOTA,SD,CORSON,46031,1283,622,647,1269,50.98502758077226,49.01497241922774,1175,535,588,1123,52.359750667853966,47.640249332146034,-2.6255340591713527,2.8856336949397265
SOUTH DAKOTA,SD,CUSTER,46033,5494,1522,3852,5374,71.67845180498698,28.321548195013026,4721,1121,3293,4414,74.60353420933394,25.396465790666063,-3.9208362383199247,11.517675051549947
SOUTH DAKOTA,SD,DAVISON,46035,8454,2648,5613,8261,67.9457692773272,32.0542307226728,7952,2355,5157,7512,68.65015974440895,31.349840255591054,-1.0260580160399657,2.246870993086225
SOUTH DAKOTA,SD,DAY,46037,2964,1052,1869,2921,63.9849366655255,36.0150633344745,2747,974,1627,2601,62.55286428296809,37.44713571703191,2.289379389693824,-3.824250787507022
SOUTH DAKOTA,SD,DEUEL,46039,2350,609,1699,2308,73.61351819757365,26.386481802426342,2080,570,1366,1936,70.55785123966942,29.44214876033058,4.330725644584632,-10.378546018425617
SOUTH DAKOTA,SD,DEWEY,46041,1966,1131,790,1921,41.12441436751692,58.87558563248308,1708,888,723,1611,44.878957169459966,55.121042830540034,-8.365931471549438,6.811450961633159
SOUTH DAKOTA,SD,DOUGLAS,46043,1707,216,1468,1684,87.17339667458432,12.826603325415677,1605,214,1338,1552,86.21134020618557,13.788659793814434,1.1159279812816614,-6.977157191377903
SOUTH DAKOTA,SD,EDMUNDS,46045,1985,417,1538,1955,78.67007672634271,21.32992327365729,1918,380,1433,1813,79.04026475455046,20.959735245449533,-0.4683537300353424,1.7661865661596332
SOUTH DAKOTA,SD,FALL RIVER,46047,4042,1053,2878,3931,73.2129229203765,26.787077079623504,3563,821,2511,3332,75.36014405762305,24.63985594237695,-2.8492795019137818,8.71442244738796
SOUTH DAKOTA,SD,FAULK,46049,1182,198,964,1162,82.96041308089501,17.03958691910499,1118,204,858,1062,80.7909604519774,19.2090395480226,2.685266540688236,-11.293915156424017
SOUTH DAKOTA,SD,GRANT,46051,3745,1056,2618,3674,71.25748502994011,28.74251497005988,3564,971,2382,3353,71.04085893229943,28.959141067700568,0.30493169831620204,-0.748040479288592
SOUTH DAKOTA,SD,GREGORY,46053,2258,455,1771,2226,79.55974842767296,20.440251572327043,2091,391,1600,1991,80.3616273229533,19.63837267704671,-0.9978380503144701,4.083224758320059
SOUTH DAKOTA,SD,HAAKON,46055,1137,105,1026,1131,90.71618037135279,9.283819628647215,1044,77,936,1013,92.39881539980257,7.601184600197433,-1.821056927157727,22.136484205449737
SOUTH DAKOTA,SD,HAMLIN,46057,3083,647,2372,3019,78.5690626035111,21.430937396488904,2762,555,2051,2606,78.70299309286263,21.297006907137376,-0.1701720405899998,0.6288700094596145
SOUTH DAKOTA,SD,HAND,46059,1836,373,1433,1806,79.34662236987819,20.653377630121817,1818,334,1391,1725,80.6376811594203,19.36231884057971,-1.6010614032783144,6.667893448982443
SOUTH DAKOTA,SD,HANSON,46061,2388,557,1793,2350,76.29787234042553,23.70212765957447,2006,424,1497,1921,77.92816241540864,22.071837584591357,-2.092042240509384,7.3862906463267874
SOUTH DAKOTA,SD,HARDING,46063,813,49,748,797,93.85194479297365,6.148055207026349,770,38,695,733,94.81582537517053,5.184174624829468,-1.0165819665472142,18.592749125008257
SOUTH DAKOTA,SD,HUGHES,46065,8723,2953,5522,8475,65.15634218289085,34.84365781710915,8175,2450,5174,7624,67.86463798530954,32.13536201469045,-3.990731967073846,8.427774366383733
SOUTH DAKOTA,SD,HUTCHINSON,46067,3767,762,2944,3706,79.43874797625472,20.56125202374528,3365,692,2517,3209,78.43564973511998,21.564350264880026,1.278880514819769,-4.651650658672546
SOUTH DAKOTA,SD,HYDE,46069,710,136,564,700,80.57142857142857,19.428571428571427,690,125,543,668,81.2874251497006,18.7125748502994,-0.8808208366219428,3.8262857142857154
SOUTH DAKOTA,SD,JACKSON,46071,1115,359,738,1097,67.27438468550592,32.72561531449408,1095,323,722,1045,69.0909090909091,30.90909090909091,-2.6291800604519633,5.876990723363185
SOUTH DAKOTA,SD,JERAULD,46073,1006,270,721,991,72.7547931382442,27.2452068617558,967,264,648,912,71.05263157894737,28.94736842105263,2.395634787158496,-5.880194477570866
SOUTH DAKOTA,SD,JONES,46075,599,90,498,588,84.6938775510204,15.306122448979592,558,69,450,519,86.70520231213872,13.294797687861271,-2.3197278911564645,15.128660159716055
SOUTH DAKOTA,SD,KINGSBURY,46077,2779,819,1904,2723,69.9228791773779,30.077120822622106,2551,703,1680,2383,70.49937054133446,29.500629458665546,-0.8177255478026724,1.9541663162282896
SOUTH DAKOTA,SD,LAKE,46079,5873,2068,3681,5749,64.0285267002957,35.97147329970429,6786,2314,4038,6352,63.57052896725441,36.42947103274559,0.7204560674289873,-1.257217631926666
SOUTH DAKOTA,SD,LAWRENCE,46081,13828,4537,8753,13290,65.86155003762227,34.13844996237773,11842,3356,7411,10767,68.83068635645955,31.16931364354045,-4.3136811152234555,9.525831568808396
SOUTH DAKOTA,SD,LINCOLN,46083,32396,11981,19617,31598,62.08304323058422,37.91695676941578,25231,8076,15499,23575,65.74337221633085,34.25662778366914,-5.567601512289633,10.685024249501884
SOUTH DAKOTA,SD,LYMAN,46085,1597,525,1042,1567,66.49649010848755,33.503509891512444,1421,369,977,1346,72.58543833580981,27.41456166419019,-8.388663576229028,22.210634997224265
SOUTH DAKOTA,SD,MARSHALL,46091,2178,858,1287,2145,60,40,1947,754,1056,1810,58.34254143646409,41.65745856353591,2.840909090909083,-3.9787798408488007
SOUTH DAKOTA,SD,MCCOOK,46087,2900,769,2068,2837,72.8939020091646,27.10609799083539,2587,623,1794,2417,74.22424493173355,25.775755068266445,-1.7923293443975141,5.161218047911942
SOUTH DAKOTA,SD,MCPHERSON,46089,1324,222,1075,1297,82.88357748650732,17.116422513492676,1137,192,892,1084,82.28782287822878,17.71217712177122,0.7239887840515102,-3.363531225905947
SOUTH DAKOTA,SD,MEADE,46093,13670,3285,9875,13160,75.03799392097264,24.962006079027354,11621,2223,8441,10664,79.15416354088522,20.84583645911478,-5.200193439965384,19.745763754722322
SOUTH DAKOTA,SD,MELLETTE,46095,769,298,449,747,60.107095046854084,39.892904953145916,683,238,402,640,62.8125,37.1875,-4.30711236321738,7.275038529468003
SOUTH DAKOTA,SD,MINER,46097,1138,320,787,1107,71.09304426377597,28.906955736224027,1064,281,706,987,71.52988855116514,28.470111448834853,-0.6107157388854367,1.5343961268794226
SOUTH DAKOTA,SD,MINNEHAHA,46099,92326,40482,49249,89731,54.88515674627498,45.11484325372502,78263,30610,42043,72653,57.86822292265977,42.13177707734023,-5.154929641388195,7.080323649555176
SOUTH DAKOTA,SD,MOODY,46101,3206,1179,1951,3130,62.33226837060703,37.66773162939297,2933,1043,1731,2774,62.40086517664023,37.59913482335977,-0.10992925472911308,0.18244251192338634
SOUTH DAKOTA,SD,OGLALA LAKOTA,46113,3200,2829,297,3126,9.500959692898272,90.49904030710172,2905,2510,241,2751,8.76045074518357,91.23954925481642,8.452863548394784,-0.8116096076347223
SOUTH DAKOTA,SD,PENNINGTON,46103,57518,20606,35063,55669,62.98478506888933,37.01521493111067,47743,14074,29804,43878,67.92470030539222,32.07529969460778,-7.272634570771508,15.40099479517365
SOUTH DAKOTA,SD,PERKINS,46105,1669,239,1401,1640,85.42682926829268,14.573170731707316,1606,188,1333,1521,87.6397107166338,12.360289283366207,-2.5249757561341735,17.903152568759715
SOUTH DAKOTA,SD,POTTER,46107,1380,227,1139,1366,83.38213762811128,16.617862371888727,1337,215,1071,1286,83.2814930015552,16.71850699844479,0.12084872992634832,-0.6019953011679013
SOUTH DAKOTA,SD,ROBERTS,46109,4307,1828,2404,4232,56.805293005671075,43.194706994328925,3889,1540,2144,3684,58.19761129207383,41.80238870792617,-2.3923976525689117,3.3307146539660604
SOUTH DAKOTA,SD,SANBORN,46111,1185,257,905,1162,77.8829604130809,22.117039586919105,1123,241,819,1060,77.26415094339623,22.735849056603772,0.8009011451352244,-2.721734596953307
SOUTH DAKOTA,SD,SPINK,46115,3163,998,2104,3102,67.82720825274016,32.17279174725983,2951,919,1854,2773,66.85899747565813,33.14100252434187,1.448138341342231,-2.921489102120245
SOUTH DAKOTA,SD,STANLEY,46117,1652,421,1203,1624,74.07635467980296,25.923645320197043,1567,329,1148,1477,77.72511848341232,22.274881516587676,-4.694446113180328,16.38062048003355
SOUTH DAKOTA,SD,SULLY,46119,930,185,726,911,79.69264544456641,20.30735455543359,861,137,679,816,83.21078431372548,16.78921568627451,-4.227984266912821,20.954754140392783
SOUTH DAKOTA,SD,TODD,46121,2539,1963,532,2495,21.322645290581164,78.67735470941884,2125,1505,487,1992,24.447791164658636,75.55220883534136,-12.782937538320994,4.136405701768986
SOUTH DAKOTA,SD,TRIPP,46123,2696,495,2161,2656,81.36295180722891,18.637048192771083,2630,462,2069,2531,81.7463453180561,18.253654681943896,-0.4690038549558295,2.10036574870911
SOUTH DAKOTA,SD,TURNER,46125,4548,1139,3290,4429,74.28313389026869,25.716866109731317,4150,961,2937,3898,75.34633145202667,24.653668547973318,-1.4110807271816905,4.312532877973663
SOUTH DAKOTA,SD,UNION,46127,8855,2725,5944,8669,68.56615526588995,31.433844734110046,7897,2227,5290,7517,70.37381934282294,29.626180657177066,-2.5686598991125353,6.101576500361561
SOUTH DAKOTA,SD,WALWORTH,46129,2580,565,1966,2531,77.67680758593441,22.323192414065588,2477,457,1896,2353,80.57798555036123,19.42201444963876,-3.600459783911558,14.937574945943833
SOUTH DAKOTA,SD,YANKTON,46135,10900,4016,6581,10597,62.10248183448146,37.89751816551854,9623,3301,5659,8960,63.158482142857146,36.841517857142854,-1.6719849378063478,2.8663322517558765
SOUTH DAKOTA,SD,ZIEBACH,46137,906,481,404,885,45.64971751412429,54.35028248587571,767,353,368,721,51.04022191400832,48.95977808599168,-10.56128715303366,11.010067060386364
TENNESSEE,TN,ANDERSON,47001,35570,11741,23184,34925,66.38224767358625,33.61775232641374,29881,9013,19212,28225,68.06731620903454,31.932683790965456,-2.475591266553623,5.276939910465761
TENNESSEE,TN,BEDFORD,47003,19088,4453,14354,18807,76.32264582336364,23.67735417663636,15355,3395,11486,14881,77.18567300584638,22.814326994153618,-1.1181183617034351,3.782829897651152
TENNESSEE,TN,BENTON,47005,7260,1529,5668,7197,78.7550368208976,21.244963179102403,6328,1474,4716,6190,76.18739903069466,23.812600969305333,3.3701607127557542,-10.782685156958028
TENNESSEE,TN,BLEDSOE,47007,5758,971,4725,5696,82.95294943820225,17.047050561797754,4664,897,3622,4519,80.15047576897544,19.849524231024564,3.4965153261280912,-14.118593658011092
TENNESSEE,TN,BLOUNT,47009,66609,17932,47369,65301,72.53947106476164,27.460528935238358,52208,12100,37443,49543,75.57677169327654,24.423228306723452,-4.018828219921311,12.436114465992887
TENNESSEE,TN,BRADLEY,47011,45865,9851,35204,45055,78.13561202974142,21.864387970258573,38666,7070,29768,36838,80.80786144741843,19.192138552581575,-3.30691763129487,13.923666767805543
TENNESSEE,TN,CAMPBELL,47013,14933,2441,12331,14772,83.47549417817493,16.524505821825073,12532,2248,9870,12118,81.44908400726193,18.550915992738076,2.4879471581685575,-10.92350464907641
TENNESSEE,TN,CANNON,47015,6557,1261,5190,6451,80.45264300108511,19.547356998914896,5314,1127,4007,5134,78.04830541488118,21.951694585118815,3.0805762833967965,-10.952856404233291
TENNESSEE,TN,CARROLL,47017,11905,2559,9205,11764,78.2471948316899,21.752805168310097,10384,2327,7756,10083,76.92155112565705,23.078448874342953,1.7233710015380543,-5.744076273282895
TENNESSEE,TN,CARTER,47019,24492,4529,19584,24113,81.21760046447974,18.78239953552026,21084,3453,16898,20351,83.03277480222103,16.96722519777898,-2.1860937949682135,10.69812132851804
TENNESSEE,TN,CHEATHAM,47021,20260,5514,14438,19952,72.36367281475542,27.636327185244586,15924,3878,11297,15175,74.44481054365733,25.555189456342667,-2.795544395510885,8.143699080991906
TENNESSEE,TN,CHESTER,47023,7584,1412,5952,7364,80.8256382400869,19.17436175991309,6507,1243,5081,6324,80.34471853257432,19.65528146742568,0.5985704054929375,-2.446770901294948
TENNESSEE,TN,CLAIBORNE,47025,12945,2202,10604,12806,82.80493518663127,17.195064813368734,10740,1832,8602,10434,82.44201648456968,17.557983515430323,0.4402108506522451,-2.066972564034175
TENNESSEE,TN,CLAY,47027,3506,735,2733,3468,78.80622837370242,21.19377162629758,2920,707,2141,2848,75.1755617977528,24.82443820224719,4.829583562963347,-14.625372571859252
TENNESSEE,TN,COCKE,47029,14859,2533,12162,14695,82.76284450493365,17.23715549506635,12126,1981,9791,11772,83.1719334012912,16.8280665987088,-0.49185930833632874,2.4309916647758945
TENNESSEE,TN,COFFEE,47031,24282,5705,17883,23588,75.81397320671527,24.18602679328472,19971,4743,14417,19160,75.24530271398747,24.754697286012526,0.755755472058306,-2.2972225681350933
TENNESSEE,TN,CROCKETT,47033,6114,1382,4673,6055,77.1758876961189,22.82411230388109,5397,1303,3982,5285,75.34531693472091,24.65468306527909,2.4295747046681138,-7.42483996468798
TENNESSEE,TN,CUMBERLAND,47035,32279,6728,25168,31896,78.90644594933534,21.09355405066466,26360,5202,20413,25615,79.69158696076518,20.308413039234825,-0.9852244651827435,3.8660874678537516
TENNESSEE,TN,DAVIDSON,47037,309658,199703,100218,299921,33.41479923046402,66.58520076953597,249068,148864,84550,233414,36.22319141096935,63.77680858903065,-7.753022500537798,4.4034692902277905
TENNESSEE,TN,DECATUR,47039,5241,904,4229,5133,82.38846678355738,17.611533216442627,4592,894,3588,4482,80.05354752342704,19.946452476572958,2.9166968015340355,-11.70593749877421
TENNESSEE,TN,DEKALB,47041,8513,1750,6672,8422,79.2210876276419,20.77891237235811,6955,1569,5171,6740,76.72106824925817,23.27893175074184,3.258582597235793,-10.739407654752286
TENNESSEE,TN,DICKSON,47043,24323,6106,17643,23749,74.28944376605331,25.710556233946694,18699,4722,13233,17955,73.70091896407686,26.29908103592314,0.7985311584287169,-2.2378150824835075
TENNESSEE,TN,DYER,47045,15079,3158,11768,14926,78.84228862387779,21.157711376122204,13336,2816,10180,12996,78.33179439827639,21.668205601723606,0.6517075595202204,-2.3559598565041973
TENNESSEE,TN,FAYETTE,47047,22984,7027,15690,22717,69.06721838270899,30.932781617291017,19394,5874,13055,18929,68.96824977547678,31.03175022452322,0.1434987948141231,-0.3189269265063577
TENNESSEE,TN,FENTRESS,47049,8729,1214,7441,8655,85.9734257654535,14.026574234546505,7333,1100,6038,7138,84.58952087419445,15.410479125805548,1.6360240334228449,-8.980284648915493
TENNESSEE,TN,FRANKLIN,47051,19132,4864,13987,18851,74.19765529680123,25.80234470319877,16404,4374,11532,15906,72.50094304036213,27.499056959637873,2.340262326649345,-6.170074337201726
TENNESSEE,TN,GIBSON,47053,22335,5771,16259,22030,73.80390376758965,26.19609623241035,19547,5258,13786,19044,72.39025414828818,27.609745851711825,1.9528175939342196,-5.120110945222001
TENNESSEE,TN,GILES,47055,13203,3298,9784,13082,74.78978749426693,25.210212505733068,11137,2917,7970,10887,73.20657665105172,26.793423348948288,2.1626620389064044,-5.908953188235888
TENNESSEE,TN,GRAINGER,47057,10134,1467,8565,10032,85.37679425837321,14.623205741626794,8008,1154,6626,7780,85.16709511568124,14.832904884318767,0.24622084668632915,-1.4137429204016838
TENNESSEE,TN,GREENE,47059,28087,5199,22259,27458,81.06562750382402,18.93437249617598,23583,4216,18562,22778,81.49091228378259,18.5090877162174,-0.5218800085064368,2.2977079501651954
TENNESSEE,TN,GRUNDY,47061,5855,988,4802,5790,82.93609671848014,17.063903281519863,4763,999,3636,4635,78.44660194174757,21.553398058252426,5.722994579250673,-20.82963792808351
TENNESSEE,TN,HAMBLEN,47063,24631,5500,18811,24311,77.37649623627165,22.623503763728355,20692,4075,15857,19932,79.55548866144893,20.444511338551074,-2.7389592620693515,10.658080249971436
TENNESSEE,TN,HAMILTON,47065,171113,75522,92108,167630,54.947205154208675,45.052794845791325,142408,55316,78733,134049,58.734492610910934,41.265507389089066,-6.448148759522454,9.177852633659
TENNESSEE,TN,HANCOCK,47067,2744,362,2372,2734,86.75932699341624,13.24067300658376,2231,322,1843,2165,85.1270207852194,14.872979214780601,1.9174948132100633,-10.974978076851427
TENNESSEE,TN,HARDEMAN,47069,10063,4180,5760,9940,57.947686116700204,42.052313883299796,9273,4185,4919,9104,54.03119507908612,45.96880492091388,7.248573776466483,-8.519888747058225
TENNESSEE,TN,HARDIN,47071,11538,1775,9559,11334,84.3391565202047,15.660843479795306,9949,1622,8012,9634,83.16379489308699,16.836205106913017,1.4133092755431953,-6.981155311746012
TENNESSEE,TN,HAWKINS,47073,24824,4083,20405,24488,83.3265272786671,16.6734727213329,20774,3507,16648,20155,82.59985115355991,17.40014884644009,0.8797547634271652,-4.176263844178907
TENNESSEE,TN,HAYWOOD,47075,7439,4012,3343,7355,45.452073419442556,54.547926580557444,6834,3711,3013,6724,44.80963712076145,55.19036287923855,1.43370118563948,-1.164037098445636
TENNESSEE,TN,HENDERSON,47077,12020,2092,9797,11889,82.40390276726386,17.596097232736142,10217,1800,8138,9938,81.88770376333267,18.112296236667337,0.6303742567053572,-2.849992056149009
TENNESSEE,TN,HENRY,47079,15047,3548,11239,14787,76.00595117332793,23.994048826672078,12945,3063,9508,12571,75.63439662715774,24.365603372842255,0.491250757247097,-1.5249142017320638
TENNESSEE,TN,HICKMAN,47081,9832,2130,7577,9707,78.05707221592665,21.942927784073348,7813,1824,5695,7519,75.74145498071552,24.25854501928448,3.0572653189732346,-9.545573460280977
TENNESSEE,TN,HOUSTON,47083,3686,871,2718,3589,75.73140150459739,24.268598495402617,3168,866,2182,3048,71.58792650918635,28.412073490813647,5.787952239235961,-14.583500907636049
TENNESSEE,TN,HUMPHREYS,47085,8236,2017,6120,8137,75.2119945926017,24.788005407398305,7153,1967,4930,6897,71.4803537770045,28.519646222995505,5.220512516262454,-13.084456891293284
TENNESSEE,TN,JACKSON,47087,5323,1135,4118,5253,78.39329906719969,21.606700932800305,4466,1129,3236,4365,74.13516609392899,25.86483390607102,5.7437424067758425,-16.463020751396517
TENNESSEE,TN,JEFFERSON,47089,23616,4654,18651,23305,80.0300364728599,19.9699635271401,19072,3494,14776,18270,80.87575259989053,19.124247400109468,-1.045697999516082,4.422219130180194
TENNESSEE,TN,JOHNSON,47091,7801,1246,6468,7714,83.8475499092559,16.1524500907441,6579,988,5410,6398,84.55767427321038,15.442325726789623,-0.8398106618448753,4.598558381154594
TENNESSEE,TN,KNOX,47093,220556,91422,124540,215962,57.66755262499884,42.33244737500116,180697,62878,105767,168645,62.7157638827122,37.2842361172878,-8.049349868645894,13.539800686362003
TENNESSEE,TN,LAKE,47095,2034,526,1492,2018,73.93458870168483,26.065411298315162,1970,577,1357,1934,70.16546018614271,29.83453981385729,5.371771959512506,-12.633439426444504
TENNESSEE,TN,LAUDERDALE,47097,8965,3193,5674,8867,63.99007556106913,36.00992443893087,8087,3056,4884,7940,61.51133501259446,38.48866498740554,4.029729720493225,-6.440183231311824
TENNESSEE,TN,LAWRENCE,47099,18718,3195,15334,18529,82.75675967402451,17.2432403259755,15666,2821,12420,15241,81.49071583229447,18.50928416770553,1.5536050073919005,-6.840047568878916
TENNESSEE,TN,LEWIS,47101,5609,1072,4474,5546,80.67075369635774,19.329246303642265,4622,890,3585,4475,80.11173184357541,19.88826815642458,0.6978027311578483,-2.8108121249447837
TENNESSEE,TN,LINCOLN,47103,15608,2919,12281,15200,80.79605263157895,19.20394736842105,13348,2554,10398,12952,80.28103767757875,19.71896232242125,0.6415150686873039,-2.6117751308576964
TENNESSEE,TN,LOUDON,47105,29347,6948,21713,28661,75.757998674156525,24.242001325843482,23391,4919,17610,22529,78.16591948155711,21.834080518442896,-3.080525148775004,11.028267507608813
TENNESSEE,TN,MACON,47111,9487,1307,8096,9403,86.10018079336382,13.89981920663618,7504,1072,6263,7335,85.38513974096796,14.614860259032039,0.8374303240178183,-4.892561678473539
TENNESSEE,TN,MADISON,47113,42950,18390,23943,42333,56.558713060732764,43.441286939267236,38120,15448,21335,36783,58.00233803659299,41.99766196340701,-2.488908248749311,3.437393674719491
TENNESSEE,TN,MARION,47115,13256,3177,9911,13088,75.72585574572128,24.274144254278728,10862,2832,7696,10528,73.10030395136778,26.89969604863222,3.5917111864544715,-9.760525879574
TENNESSEE,TN,MARSHALL,47117,14878,3605,11043,14648,75.38913162206444,24.610868377935553,11455,2852,8184,11036,74.15730337078652,25.84269662921348,1.661101732783865,-4.7666397549450235
TENNESSEE,TN,MAURY,47119,46657,14418,31464,45882,68.57591212240094,31.42408787759906,35369,10038,23799,33837,70.33424949020304,29.66575050979697,-2.4999731717433304,5.927162932289232
TENNESSEE,TN,MCMINN,47107,22844,4361,18198,22559,80.66846934704553,19.331530652954473,18755,3510,14691,18201,80.71534531069722,19.284654689302787,-0.05807565274142945,0.24307390724340738
TENNESSEE,TN,MCNAIRY,47109,11275,1943,9093,11036,82.3939833272925,17.606016672707504,10038,1848,7841,9689,80.92682423366705,19.073175766332955,1.8129453460192568,-7.692264317173702
TENNESSEE,TN,MEIGS,47121,5532,1008,4467,5475,81.58904109589041,18.410958904109588,4320,856,3342,4198,79.60933777989518,20.39066222010481,2.486772747022137,-9.708872103443866
TENNESSEE,TN,MONROE,47123,20797,3764,16783,20547,81.68102399377038,18.31897600622962,17093,3186,13374,16560,80.76086956521739,19.23913043478261,1.1393567621382994,-4.7827235834392745
TENNESSEE,TN,MONTGOMERY,47125,76758,32472,42187,74659,56.506248409434896,43.493751590565104,57620,21699,32341,54040,59.846410066617324,40.153589933382676,-5.581223090013864,8.318463337210869
TENNESSEE,TN,MOORE,47127,3539,573,2888,3461,83.4440913030916,16.555908696908407,2926,496,2325,2821,82.41758241758242,17.582417582417584,1.2454974477511316,-5.838269286333442
TENNESSEE,TN,MORGAN,47129,8228,1167,6930,8097,85.58725453871804,14.412745461281956,6705,1054,5441,6495,83.7721324095458,16.227867590454196,2.1667374065380773,-11.185216536028175
TENNESSEE,TN,OBION,47131,13521,2589,10790,13379,80.64877793557066,19.35122206442933,12249,2426,9526,11952,79.70214190093708,20.297858099062918,1.187717183071646,-4.663723778211315
TENNESSEE,TN,OVERTON,47133,10037,2033,7918,9951,79.56989247311827,20.43010752688172,8229,1945,6059,8004,75.69965017491255,24.300349825087455,5.112629040244032,-15.926693755701137
TENNESSEE,TN,PERRY,47135,3428,615,2775,3390,81.85840707964601,18.141592920353983,2855,597,2167,2764,78.40086830680174,21.599131693198263,4.410077142658775,-16.00776745082344
TENNESSEE,TN,PICKETT,47137,2931,525,2381,2906,81.93392980041294,18.06607019958706,2615,536,2021,2557,79.03793508017208,20.962064919827924,3.6640566549509535,-13.815407648611732
TENNESSEE,TN,POLK,47139,8360,1492,6792,8284,81.98937711250603,18.010622887493966,6520,1252,5097,6349,80.28035911167113,19.719640888328872,2.128812102668398,-8.666577705511836
TENNESSEE,TN,PUTNAM,47141,33593,9185,23759,32944,72.11935405536668,27.88064594463332,27212,6851,19002,25853,73.5001740610374,26.499825938962598,-1.8786622253765373,5.210675756328298
TENNESSEE,TN,RHEA,47143,13637,2369,11050,13419,82.34592741634995,17.65407258365005,11062,1942,8660,10602,81.68270137709867,18.31729862290134,0.8119540956284199,-3.620763371854885
TENNESSEE,TN,ROANE,47145,25917,6043,19230,25273,76.08910695208326,23.910893047916748,21669,4837,15880,20717,76.65202490708114,23.34797509291886,-0.734381062575018,2.4109926139531224
TENNESSEE,TN,ROBERTSON,47147,33717,8692,24536,33228,73.84133863007102,26.158661369928975,27113,6637,19410,26047,74.51913848043921,25.480861519560793,-0.9095647966275267,2.6600350614042423
TENNESSEE,TN,RUTHERFORD,47149,143878,59341,81480,140821,57.860688391646136,42.139311608353864,107436,36706,64515,101221,63.73677398958714,36.26322601041286,-9.219301872575159,16.203979194387475
TENNESSEE,TN,SCOTT,47151,9052,986,8004,8990,89.03225806451613,10.96774193548387,7123,934,6044,6978,86.61507595299513,13.384924047004873,2.7907175337845036,-18.05899012226291
TENNESSEE,TN,SEQUATCHIE,47153,7252,1298,5855,7153,81.85376764993708,18.14623235006291,5694,1053,4441,5494,80.8336366945759,19.1663633054241,1.2620129404986136,-5.3225066180003555
TENNESSEE,TN,SEVIER,47155,43535,8721,33783,42504,79.4819311123659,20.518068887634104,36312,6297,28629,34926,81.97045181240337,18.02954818759663,-3.035875300202895,13.802457355805743
TENNESSEE,TN,SHELBY,47157,382055,246105,129815,375920,34.5326133219834,65.4673866780166,337383,208992,116344,325336,35.7611822853911,64.2388177146089,-3.435481952478925,1.9125024511905009
TENNESSEE,TN,SMITH,47159,9051,1802,7136,8938,79.83889013202058,20.161109867979413,7436,1689,5494,7183,76.48614784908813,23.513852150911877,4.383463381562391,-14.258583669806924
TENNESSEE,TN,STEWART,47161,6296,1232,4950,6182,80.0711743772242,19.9288256227758,5299,1222,3864,5086,75.97325992921746,24.02674007078254,5.393890497557519,-17.055640656761273
TENNESSEE,TN,SULLIVAN,47163,74357,17272,55860,73132,76.38243176721545,23.617568232784553,62278,12578,46979,59557,78.88073610154977,21.119263898450225,-3.1671919632165313,11.829504789310663
TENNESSEE,TN,SUMNER,47165,92630,27680,63454,91134,69.62714244957974,30.37285755042026,71505,18161,50129,68290,73.40606238102211,26.59393761897789,-5.147967087278815,14.209704428071102
TENNESSEE,TN,TIPTON,47167,27308,6837,20070,26907,74.59025532389342,25.40974467610659,23481,5785,16910,22695,74.50980392156863,25.49019607843137,0.10797425048851839,-0.3156170398895153
TENNESSEE,TN,TROUSDALE,47169,3998,1012,2936,3948,74.36676798378926,25.63323201621074,3160,946,2103,3049,68.97343391275828,31.02656608724172,7.8194367962783895,-17.38295516128272
TENNESSEE,TN,UNICOI,47171,8307,1615,6599,8214,80.33844655466277,19.66155344533723,7195,1262,5671,6933,81.79720178854753,18.202798211452475,-1.7833803626385203,8.013906526563396
TENNESSEE,TN,UNION,47173,8123,1249,6803,8052,84.4883258817685,15.511674118231495,6247,1012,5053,6065,83.31409727947238,16.68590272052762,1.409399658208188,-7.037249479175878
TENNESSEE,TN,VAN BUREN,47175,2921,544,2342,2886,81.15038115038115,18.84961884961885,2419,539,1820,2359,77.1513353115727,22.8486646884273,5.183378644917114,-17.5023175023175
TENNESSEE,TN,WARREN,47177,16009,3924,11850,15774,75.12362114872575,24.87637885127425,13612,3535,9540,13075,72.96367112810708,27.036328871892927,2.9603088594957194,-7.989065493518865
TENNESSEE,TN,WASHINGTON,47179,60203,18638,40444,59082,68.45401306658542,31.545986933414575,49750,13024,34252,47276,72.45113799813859,27.54886200186141,-5.516993993463382,14.509219768435777
TENNESSEE,TN,WAYNE,47181,6669,820,5795,6615,87.60393046107332,12.396069538926682,5857,717,5036,5753,87.53693725013036,12.463062749869634,0.07653136269951677,-0.5375340900345971
TENNESSEE,TN,WEAKLEY,47183,13735,3020,10396,13416,77.48956469886703,22.510435301132976,12184,2772,9008,11780,76.4685908319185,23.531409168081495,1.335154546253725,-4.338770617840392
TENNESSEE,TN,WHITE,47185,11895,2143,9606,11749,81.76014979998298,18.239850200017024,9825,1845,7671,9516,80.61160151324086,19.388398486759144,1.424792790592888,-5.923894578123578
TENNESSEE,TN,WILLIAMSON,47187,139016,50161,86469,136630,63.28697943350655,36.71302056649345,106271,31013,68212,99225,68.74477198286722,31.25522801713278,-7.9392110729829435,17.462014823148753
TENNESSEE,TN,WILSON,47189,74330,22254,50296,72550,69.32598208132323,30.674017918676775,56734,14385,39406,53791,73.25760815006228,26.74239184993772,-5.366850171637372,14.701848999898681
TEXAS,TX,ANDERSON,48001,19227,3955,15110,19065,79.25517964857067,20.744820351429322,16977,3369,13201,16570,79.66807483403741,20.331925165962584,-0.5182693146870587,2.0307726990750563
TEXAS,TX,ANDREWS,48003,5863,850,4943,5793,85.32711893664768,14.672881063352321,4943,836,3927,4763,82.44803695150115,17.551963048498845,3.491995797110503,-16.40319078379533
TEXAS,TX,ANGELINA,48005,34574,9143,25076,34219,73.28092580145533,26.719074198544668,29911,7538,21668,29206,74.19023488324316,25.809765116756832,-1.2256452391866124,3.523120329357332
TEXAS,TX,ARANSAS,48007,12290,2916,9239,12155,76.00987248046071,23.990127519539286,10512,2465,7740,10205,75.84517393434591,24.154826065654092,0.2171509900648072,-0.6818452994326929
TEXAS,TX,ARCHER,48009,4796,446,4300,4746,90.60261272650654,9.397387273493468,4283,394,3786,4180,90.57416267942584,9.425837320574162,0.03141077569923656,-0.30183044872411635
TEXAS,TX,ARMSTRONG,48011,1112,75,1035,1110,93.24324324324324,6.756756756756757,1021,70,924,994,92.95774647887323,7.042253521126761,0.30712530712531105,-4.054054054054057
TEXAS,TX,ATASCOSA,48013,18118,5876,12039,17915,67.2006698297516,32.799330170248396,13673,4651,8618,13269,64.948375913784,35.051624086215995,3.467821765023671,-6.425647811432822
TEXAS,TX,AUSTIN,48015,14554,2951,11447,14398,79.50409779135991,20.49590220864009,12274,2320,9637,11957,80.59713975077361,19.402860249226393,-1.356179589987505,5.633406339961011
TEXAS,TX,BAILEY,48017,1860,409,1434,1843,77.80792186652198,22.192078133478024,1793,397,1344,1741,77.19701321079839,22.802986789201608,0.7913630726300358,-2.6790729713218164
TEXAS,TX,BANDERA,48019,12715,2505,10057,12562,80.05890781722655,19.941092182773442,10218,1726,8163,9889,82.54626352512894,17.453736474871068,-3.013286854764996,14.25113591856697
TEXAS,TX,BASTROP,48021,36665,15474,20516,35990,57.00472353431509,42.99527646568491,28454,10569,16328,26897,60.70565490575157,39.29434509424843,-6.0965183180749065,9.418483404061595
TEXAS,TX,BAYLOR,48023,1702,183,1494,1677,89.08765652951699,10.912343470483005,1499,191,1267,1458,86.89986282578874,13.100137174211248,2.517603172877503,-16.70054041903549
TEXAS,TX,BEE,48025,9420,3288,6006,9294,64.62233699160748,35.37766300839251,8485,3444,4744,8188,57.93844650708354,42.06155349291646,11.536192092597396,-15.890736146133012
TEXAS,TX,BELL,48027,127375,57014,67893,124907,54.354840000960714,45.645159999039286,94994,37801,51998,89799,57.90487644628559,42.09512355371441,-6.130807391702153,8.433367444081608
TEXAS,TX,BEXAR,48029,770818,448452,308618,757070,40.76479057418733,59.23520942581267,589645,319550,240333,559883,42.92557552202871,57.07442447797129,-5.0337937734404985,3.7859075542239884
TEXAS,TX,BLANCO,48031,7441,1911,5443,7354,74.01414196355725,25.985858036442753,5685,1244,4212,5456,77.19941348973607,22.80058651026393,-4.126030732866015,13.9701297804113
TEXAS,TX,BORDEN,48033,416,16,397,413,96.12590799031477,3.87409200968523,365,31,330,361,91.41274238227147,8.587257617728532,5.15591752879887,-54.885573693665556
TEXAS,TX,BOSQUE,48035,9126,1561,7469,9030,82.71317829457364,17.286821705426355,7838,1278,6339,7617,83.22174084285152,16.778259157148483,-0.6110933791185658,3.0310805400880714
TEXAS,TX,BOWIE,48037,38261,10747,27116,37863,71.61608958613951,28.383910413860498,34602,8838,24924,33762,73.82264083881287,26.177359161187134,-2.988989864899616,8.429235504951137
TEXAS,TX,BRAZORIA,48039,154984,62228,90433,152661,59.23778830218589,40.76221169781411,121181,43200,72791,115991,62.75573104809856,37.24426895190144,-5.605771277234228,9.44559483891565
TEXAS,TX,BRAZOS,48041,85061,35349,47530,82879,57.34866492115011,42.65133507884989,67211,23121,38738,61859,62.6230621251556,37.3769378748444,-8.422451769388594,14.111367875203307
TEXAS,TX,BREWSTER,48043,4822,2258,2461,4719,52.150879423606696,47.849120576393304,4252,1873,2077,3950,52.58227848101266,47.41772151898734,-0.8204267100402229,0.9097844510163045
TEXAS,TX,BRISCOE,48045,725,78,639,717,89.1213389121339,10.878661087866108,736,91,625,716,87.29050279329608,12.70949720670391,2.0974058577405863,-14.405260011954567
TEXAS,TX,BROOKS,48047,2484,1470,998,2468,40.437601296596434,59.56239870340357,2596,1937,613,2550,24.03921568627451,75.96078431372548,68.21514405598843,-21.587962470996846
TEXAS,TX,BROWN,48049,15969,2107,13698,15805,86.66877570389117,13.331224296108827,14026,1621,12017,13638,88.1140929755096,11.885907024490395,-1.640279350115026,12.159924090272778
TEXAS,TX,BURLESON,48051,8609,1788,6743,8531,79.04114406282967,20.95885593717032,6960,1491,5316,6807,78.09607756721023,21.903922432789773,1.2101331143117955,-4.3145993532405225
TEXAS,TX,BURNET,48053,24717,5639,18767,24406,76.8950258133246,23.104974186675406,19204,3797,14638,18435,79.40330892324383,20.59669107675617,-3.158915093001846,12.178087735412468
TEXAS,TX,CALDWELL,48055,14973,6672,8031,14703,54.62150581513977,45.37849418486023,12092,4795,6691,11486,58.253526031690754,41.746473968309246,-6.234850427037008,8.700184401940469
TEXAS,TX,CALHOUN,48057,7856,2148,5641,7789,72.42264732314803,27.57735267685197,6965,2118,4638,6756,68.65008880994671,31.349911190053287,5.4953439661897585,-12.033713557690318
TEXAS,TX,CALLAHAN,48059,6832,734,6012,6746,89.11947820930922,10.88052179069078,5579,569,4865,5434,89.5288921604711,10.471107839528893,-0.4572981316780411,3.9099392102174058
TEXAS,TX,CAMERON,48061,114174,64063,49032,113095,43.35470179937221,56.64529820062779,92079,59402,29472,88874,33.161554560388865,66.83844543961114,30.737844995840312,-15.250425368125741
TEXAS,TX,CAMP,48063,5060,1394,3626,5020,72.23107569721115,27.768924302788843,4542,1260,3201,4461,71.75521183591123,28.24478816408877,0.6631767214179796,-1.6847846708404557
TEXAS,TX,CARSON,48065,3122,297,2779,3076,90.34460338101431,9.655396618985696,2964,249,2620,2869,91.32101777622866,8.67898222377135,-1.069211030484718,11.250332931204653
TEXAS,TX,CASS,48067,13927,2795,11033,13828,79.78738790859127,20.212612091408737,12344,2391,9726,12117,80.26739291903937,19.732607080960634,-0.5980074760024268,2.4325473490588223
TEXAS,TX,CASTRO,48069,2083,466,1602,2068,77.4661508704062,22.53384912959381,1997,526,1414,1940,72.88659793814433,27.11340206185567,6.283120713287138,-16.89036632811408
TEXAS,TX,CHAMBERS,48071,21652,3997,17353,21350,81.27868852459017,18.721311475409838,16786,2948,13339,16287,81.899674587094,18.100325412906,-0.7582277532048765,3.4308005427408528
TEXAS,TX,CHEROKEE,48073,19508,4210,15101,19311,78.19895396406193,21.801046035938068,16790,3469,12919,16388,78.83207224798633,21.167927752013668,-0.8031227213370351,2.9909318065589607
TEXAS,TX,CHILDRESS,48075,2279,310,1943,2253,86.24056813138039,13.759431868619618,2084,253,1802,2055,87.68856447688565,12.311435523114355,-1.6512943895745313,11.761393241159347
TEXAS,TX,CLAY,48077,5744,614,5069,5683,89.19584726376914,10.804152736230863,5018,536,4377,4913,89.09016893954814,10.909831060451863,0.11861951265657034,-0.9686522516749507
TEXAS,TX,COCHRAN,48079,1000,177,809,986,82.04868154158216,17.95131845841785,901,190,679,869,78.13578826237054,21.86421173762946,5.007811869859924,-17.89633820860469
TEXAS,TX,COKE,48081,1779,178,1586,1764,89.9092970521542,10.090702947845806,1423,140,1265,1405,90.0355871886121,9.9644128113879,-0.14026691045323503,1.2674117265954132
TEXAS,TX,COLEMAN,48083,4124,451,3641,4092,88.97849462365592,11.021505376344086,3643,388,3177,3565,89.1164095371669,10.8835904628331,-0.1547581575910173,1.267182130584188
TEXAS,TX,COLLIN,48085,490856,230945,252318,483263,52.21132178544602,47.78867821455398,361419,140624,201014,341638,58.83830253074892,41.16169746925108,-11.263038633447387,16.099872339456933
TEXAS,TX,COLLINGSWORTH,48087,1218,155,1048,1203,87.11554447215295,12.884455527847049,1156,145,983,1128,87.14539007092199,12.854609929078014,-0.03424805230058947,0.2321781752515184
TEXAS,TX,COLORADO,48089,9975,2420,7472,9892,75.53578649413667,24.464213505863324,8513,1987,6325,8312,76.09480269489895,23.90519730510106,-0.7346312507092501,2.3384713944317737
TEXAS,TX,COMAL,48091,88892,24826,62740,87566,71.6488134664139,28.351186533586095,62178,14238,45136,59374,76.01980664937514,23.98019335062485,-5.749808340241513,18.227514345072393
TEXAS,TX,COMANCHE,48093,6086,853,5177,6030,85.85406301824213,14.145936981757878,5237,789,4333,5122,84.59586099180008,15.404139008199921,1.4873092036547853,-8.167947755939354
TEXAS,TX,CONCHO,48095,1268,197,1058,1255,84.30278884462152,15.697211155378486,1068,148,885,1033,85.67279767666989,14.327202323330107,-1.5991176536790608,9.562291375040367
TEXAS,TX,COOKE,48097,18996,3210,15596,18806,82.93097947463575,17.069020525364245,15955,2352,13181,15533,84.85804416403785,15.141955835962145,-2.2709275336076806,12.726656386259695
TEXAS,TX,CORYELL,48099,23493,7565,15438,23003,67.11298526279181,32.88701473720819,18253,5064,12225,17289,70.70969980912719,29.29030019087281,-5.086592866387917,12.279541428039575
TEXAS,TX,COTTLE,48101,662,113,540,653,82.69525267993875,17.304747320061256,612,92,506,598,84.61538461538461,15.384615384615385,-2.269246832799665,12.480857580398164
TEXAS,TX,CRANE,48103,1503,241,1247,1488,83.80376344086021,16.196236559139784,1384,299,1049,1348,77.81899109792285,22.181008902077153,7.6906321432598235,-26.981515445751082
TEXAS,TX,CROCKETT,48105,1574,344,1220,1564,78.00511508951406,21.994884910485933,1395,372,980,1352,72.48520710059172,27.514792899408285,7.6152200010438875,-20.061601078018864
TEXAS,TX,CROSBY,48107,1953,527,1396,1923,72.59490379615184,27.405096203848153,1728,468,1181,1649,71.6191631291692,28.380836870830805,1.3624016594872002,-3.438026409945283
TEXAS,TX,CULBERSON,48109,864,438,415,853,48.65181711606096,51.34818288393904,767,454,280,734,38.14713896457766,61.85286103542234,27.537263439959816,-16.983334280151418
TEXAS,TX,DALLAM,48111,1609,197,1389,1586,87.57881462799496,12.421185372005045,1544,222,1261,1483,85.03034389750506,14.969656102494943,2.9971309225349074,-17.024243663587924
TEXAS,TX,DALLAS,48113,919504,598576,307076,905652,33.90662196958655,66.09337803041345,758973,461080,262945,724025,36.31711612168088,63.68288387831912,-6.637350124437036,3.7851523129827758
TEXAS,TX,DAWSON,48115,3789,808,2951,3759,78.5049215216813,21.495078478318703,3563,835,2636,3471,75.9435321233074,24.056467876692597,3.3727551599983974,-10.64740431347998
TEXAS,TX,DEAF SMITH,48117,4610,1264,3294,4558,72.2685388328214,27.731461167178587,4216,1185,2911,4096,71.0693359375,28.9306640625,1.6873703398270212,-4.145092876992829
TEXAS,TX,DELTA,48119,2592,403,2162,2565,84.28849902534112,15.71150097465887,2281,400,1836,2236,82.11091234347049,17.88908765652952,2.652006438269461,-12.172709551656924
TEXAS,TX,DENTON,48121,417964,188695,222480,411175,54.108348026995806,45.891651973004194,298645,110890,170603,281493,60.60648044533967,39.39351955466033,-10.721844216320164,16.495435015212088
TEXAS,TX,DEWITT,48123,8118,1494,6567,8061,81.46631931522144,18.533680684778563,6844,1163,5519,6682,82.59503142771625,17.404968572283746,-1.3665617567838906,6.484999428796523
TEXAS,TX,DICKENS,48125,988,130,853,983,86.77517802644964,13.224821973550355,909,128,755,883,85.5039637599094,14.4960362400906,1.4867313872252153,-8.769392166836221
TEXAS,TX,DIMMIT,48127,3666,2264,1384,3648,37.93859649122807,62.06140350877193,3225,2173,974,3147,30.950111217032095,69.04988878296791,22.579838971144483,-10.120921839804298
TEXAS,TX,DONLEY,48129,1648,198,1438,1636,87.89731051344744,12.102689486552567,1465,191,1225,1416,86.51129943502825,13.48870056497175,1.6021156628910793,-10.275349146814472
TEXAS,TX,DUVAL,48131,5053,2575,2443,5018,48.68473495416501,51.31526504583499,4168,2783,1316,4099,32.10539155891681,67.8946084410832,51.64037125921155,-24.419234127604163
TEXAS,TX,EASTLAND,48133,8293,983,7237,8220,88.04136253041362,11.958637469586375,6963,776,6011,6787,88.566376897009,11.433623102991012,-0.5927919657432668,4.591846012993206
TEXAS,TX,ECTOR,48135,44591,11367,32697,44064,74.20343137254902,25.79656862745098,36530,10249,25020,35269,70.94048597918852,29.059514020811477,4.599553200576789,-11.228492641080233
TEXAS,TX,EDWARDS,48137,1066,168,893,1061,84.16588124410933,15.83411875589067,1073,303,746,1049,71.11534795042898,28.88465204957102,18.351219068459358,-45.181549257659036
TEXAS,TX,EL PASO,48141,266729,178126,84331,262457,32.131358660656794,67.86864133934321,214008,147843,55512,203355,27.298074795308697,72.7019252046913,17.705585106605092,-6.648082360597806
TEXAS,TX,ELLIS,48139,85493,27565,56717,84282,67.29432144467383,32.705678555326166,63673,16253,44941,61194,73.44020655619832,26.55979344380168,-8.368556407615092,23.139807636413543
TEXAS,TX,ERATH,48143,16856,2916,13684,16600,82.43373493975903,17.566265060240966,13893,2160,11210,13370,83.84442782348542,16.155572176514585,-1.6825123867459157,8.73192771084339
TEXAS,TX,FALLS,48145,6133,1899,4177,6076,68.74588545095457,31.254114549045426,5248,1684,3441,5125,67.14146341463415,32.858536585365854,2.3896143377338586,-4.882816470393225
TEXAS,TX,FANNIN,48147,15007,2655,12171,14826,82.0922703358964,17.907729664103602,12044,2132,9548,11680,81.74657534246575,18.253424657534246,0.4228862089725727,-1.893863753878955
TEXAS,TX,FAYETTE,48149,12941,2661,10171,12832,79.26278054862843,20.737219451371573,11174,2144,8743,10887,80.30678791218885,19.69321208781115,-1.300023809571349,5.301356421213765
TEXAS,TX,FISHER,48151,1826,352,1448,1800,80.44444444444444,19.555555555555557,1729,403,1265,1668,75.83932853717026,24.160671462829736,6.072200263504612,-19.060380479735308
TEXAS,TX,FLOYD,48153,2039,438,1584,2022,78.33827893175074,21.661721068249257,1959,435,1474,1909,77.21320062860136,22.786799371398637,1.4571061605916924,-4.937412599338309
TEXAS,TX,FOARD,48155,551,99,445,544,81.80147058823529,18.198529411764707,513,113,383,496,77.21774193548387,22.782258064516128,5.936108124712014,-20.119729307652257
TEXAS,TX,FORT BEND,48157,357514,195552,157718,353270,44.64517224785575,55.35482775214425,262066,134686,117291,251977,46.54829607464173,53.45170392535827,-4.088493000332949,3.5604549285155995
TEXAS,TX,FRANKLIN,48159,5009,804,4161,4965,83.80664652567975,16.19335347432024,4380,665,3585,4250,84.3529411764706,15.647058823529411,-0.6476296418022498,3.491356790768463
TEXAS,TX,FREESTONE,48161,8711,1635,6991,8626,81.04567586366798,18.95432413633202,7684,1471,6026,7497,80.37881819394424,19.621181806055755,0.8296435363290611,-3.3986621005566597
TEXAS,TX,FRIO,48163,5279,2422,2823,5245,53.82268827454719,46.17731172545281,4400,2444,1856,4300,43.16279069767442,56.83720930232558,24.696960980901352,-18.755138944579752
TEXAS,TX,GAINES,48165,5996,576,5355,5931,90.28831562974203,9.711684370257966,4620,597,3907,4504,86.74511545293073,13.254884547069272,4.084610595433347,-26.731279055876243
TEXAS,TX,GALVESTON,48167,155060,58842,93911,152753,61.47898895602705,38.52101104397295,122903,43658,73757,117415,62.817357237150276,37.182642762849724,-2.1305708167100534,3.5994436696157317
TEXAS,TX,GARZA,48169,1653,231,1413,1644,85.94890510948905,14.05109489051095,1484,230,1225,1455,84.19243986254295,15.807560137457045,2.0862505586175972,-11.111551888289428
TEXAS,TX,GILLESPIE,48171,15850,3176,12514,15690,79.75780752071383,20.24219247928617,13214,2288,10446,12734,82.03235432699859,17.967645673001414,-2.772743541186118,12.65912545071246
TEXAS,TX,GLASSCOCK,48173,653,39,611,650,94,6,604,34,553,587,94.20783645655878,5.792163543441227,-0.2206148282097753,3.5882352941176476
TEXAS,TX,GOLIAD,48175,3995,877,3085,3962,77.86471479050984,22.135285209490156,3708,973,2620,3593,72.9195658224325,27.080434177567493,6.781648947443464,-18.260966333301
TEXAS,TX,GONZALES,48177,7648,1948,5627,7575,74.28382838283828,25.716171617161717,6334,1571,4587,6158,74.48847028255928,25.511529717440727,-0.2747296312365144,0.8021545630056304
TEXAS,TX,GRAY,48179,7782,829,6840,7669,89.1902464467336,10.809753553266397,7405,701,6500,7201,90.26524093875851,9.734759061241494,-1.190928513395595,11.042846415222996
TEXAS,TX,GRAYSON,48181,59474,14506,44163,58669,75.27484702312977,24.725152976870238,47416,10301,35325,45626,77.42296059264454,22.577039407355453,-2.7745174726873656,9.514593701842688
TEXAS,TX,GREGG,48183,47982,14796,32493,47289,68.7115396815327,31.288460318467298,41749,11677,28764,40441,71.12583764001879,28.874162359981206,-3.3944035509364423,8.361447609757299
TEXAS,TX,GRIMES,48185,12414,2833,9432,12265,76.90175295556462,23.098247044435386,9533,2194,7065,9259,76.30413651582245,23.695863484177558,0.7832032010718581,-2.522028539458876
TEXAS,TX,GUADALUPE,48187,77619,28805,47553,76358,62.27638230440818,37.72361769559182,57822,18391,36632,55023,66.57579557639532,33.42420442360467,-6.4579224848369865,12.863173099045678
TEXAS,TX,HALE,48189,9586,2279,7177,9456,75.89890016920474,24.101099830795263,8858,2101,6366,8467,75.18601629857092,24.813983701429077,0.9481601842061815,-2.872911819446211
TEXAS,TX,HALL,48191,1169,168,995,1163,85.55460017196904,14.445399828030954,1091,164,893,1057,84.48438978240303,15.515610217596972,1.2667551867539428,-6.89763647421513
TEXAS,TX,HAMILTON,48193,4351,641,3616,4257,84.94244773314541,15.057552266854593,3620,479,3060,3539,86.46510313647923,13.53489686352077,-1.7610057099341048,11.249848585382892
TEXAS,TX,HANSFORD,48195,2047,166,1849,2015,91.76178660049628,8.238213399503723,1947,171,1730,1901,91.00473435034192,8.995265649658075,0.8318822702563233,-8.41611887452295
TEXAS,TX,HARDEMAN,48197,1580,241,1330,1571,84.65945257797581,15.340547422024189,1513,249,1207,1456,82.89835164835165,17.10164835164835,2.124410069206939,-10.29784318687863
TEXAS,TX,HARDIN,48199,27635,3474,23858,27332,87.28962388409191,12.710376115908094,22780,2780,19606,22386,87.58152416689002,12.41847583310998,-0.3332897955074188,2.350532277236894
TEXAS,TX,HARRIS,48201,1640818,918193,700630,1618823,43.2802103750688,56.7197896249312,1312112,707914,545955,1253869,43.54162994698808,56.45837005301192,-0.6003899537926349,0.46303067494477546
TEXAS,TX,HARRISON,48203,29717,7908,21466,29374,73.0782324504664,26.9217675495336,26548,7151,18749,25900,72.38996138996139,27.61003861003861,0.9507824666424858,-2.492829040285238
TEXAS,TX,HARTLEY,48205,2078,195,1868,2063,90.54774600096947,9.452253999030537,1952,173,1730,1903,90.9090909090909,9.090909090909092,-0.39747939893358675,3.9747939893358897
TEXAS,TX,HASKELL,48207,2214,353,1840,2193,83.90332877336981,16.096671226630185,1770,314,1403,1717,81.71228887594641,18.287711124053583,2.6814080569322662,-11.980941095146413
TEXAS,TX,HAYS,48209,109395,59524,47680,107204,44.4759523898362,55.5240476101638,72164,33224,33826,67050,50.44891871737509,49.55108128262491,-11.839632006784207,12.054159410711618
TEXAS,TX,HEMPHILL,48211,1720,206,1486,1692,87.82505910165484,12.174940898345154,1695,181,1462,1643,88.98356664637858,11.016433353621425,-1.3019342653769472,10.516176220889983
TEXAS,TX,HENDERSON,48213,36317,7060,28911,35971,80.37307831308554,19.626921686914457,30045,5669,23650,29319,80.66441556669736,19.335584433302635,-0.36117196357906556,1.5067413897768667
TEXAS,TX,HIDALGO,48215,220884,128199,90527,218726,41.388312317694286,58.611687682305714,173437,118809,48642,167451,29.04849776949675,70.95150223050325,42.48004370523881,-17.391900326660657
TEXAS,TX,HILL,48217,14931,2860,11926,14786,80.65737860137969,19.342621398620317,12970,2547,10108,12655,79.87356775977874,20.126432240221256,0.981314424263946,-3.8944351002983435
TEXAS,TX,HOCKLEY,48219,8100,1482,6536,8018,81.51658767772511,18.48341232227488,7311,1260,5809,7069,82.17569670391852,17.82430329608148,-0.8020729396042703,3.6978108779056607
TEXAS,TX,HOOD,48221,32541,5648,26496,32144,82.42906918865107,17.57093081134893,26262,4008,21382,25390,84.214257581725093,15.78574241827491,-2.1198172902511248,11.30886559384965
TEXAS,TX,HOPKINS,48223,15941,3046,12719,15765,80.67871868062163,19.321281319378368,13538,2510,10707,13217,81.00930619656503,18.99069380343497,-0.40808585021238075,1.7407869315633206
TEXAS,TX,HOUSTON,48225,9438,2314,7060,9374,75.3147002346917,24.6852997653083,8353,1978,6205,8183,75.82793596480508,24.172064035194918,-0.6768425430326852,2.1232598480878773
TEXAS,TX,HOWARD,48227,10241,2069,8054,10123,79.56139484342586,20.438605156574138,8723,1770,6637,8407,78.9461163316284,21.053883668371594,0.7793651421849068,-2.9223991235487023
TEXAS,TX,HUDSPETH,48229,1165,371,779,1150,67.73913043478261,32.26086956521739,871,324,503,827,60.822249093107615,39.177750906892385,11.372288011064047,-17.655126140633392
TEXAS,TX,HUNT,48231,38597,8906,29163,38069,76.60563713257505,23.394362867424938,31554,6396,23910,30306,78.89526826371015,21.104731736289843,-2.902114640743636,10.84889947782679
TEXAS,TX,HUTCHINSON,48233,8773,965,7681,8646,88.83876937312051,11.161230626879481,8155,854,7042,7896,89.18439716312056,10.815602836879433,-0.3875428897813671,3.195640550164369
TEXAS,TX,IRION,48235,889,120,759,879,86.3481228668942,13.651877133105803,766,90,660,750,88,12,-1.8771331058020424,13.76564277588168
TEXAS,TX,JACK,48237,3782,331,3418,3749,91.17097892771406,8.829021072285943,3350,314,2973,3287,90.44721630666261,9.552783693337389,0.8002044182294332,-7.576457756038546
TEXAS,TX,JACKSON,48239,6353,1033,5231,6264,83.50893997445722,16.491060025542783,5302,904,4266,5170,82.51450676982591,17.485493230174082,1.2051616661846731,-5.687189898167944
TEXAS,TX,JASPER,48241,15611,2954,12542,15496,80.9370160041301,19.062983995869903,13419,2590,10609,13199,80.37730131070536,19.622698689294644,0.696359151523529,-2.8523838758738096
TEXAS,TX,JEFF DAVIS,48243,1305,501,784,1285,61.011673151750976,38.988326848249024,1191,422,695,1117,62.220232766338405,37.779767233661595,-1.9423900568261265,3.1989599277112646
TEXAS,TX,JEFFERSON,48245,94759,46073,47570,93643,50.79931228175091,49.20068771824909,87618,42443,42862,85305,50.245589355840806,49.754410644159194,1.1020329008156748,-1.112912239821906
TEXAS,TX,JIM HOGG,48247,2036,1197,833,2030,41.03448275862069,58.96551724137931,2119,1635,430,2065,20.82324455205811,79.17675544794189,97.06094627105053,-25.526732046820623
TEXAS,TX,JIM WELLS,48249,13669,6119,7453,13572,54.914529914529915,45.085470085470085,12379,6694,5420,12114,44.741621264652466,55.258378735347534,22.737013908600634,-18.409712486497675
TEXAS,TX,JOHNSON,48251,72020,16464,54628,71092,76.84127609294998,23.15872390705002,57606,10988,44382,55370,80.155318764674,19.84468123532599,-4.134526220840861,16.699903779883485
TEXAS,TX,JONES,48253,6741,999,5660,6659,84.99774740952095,15.002252590479051,5960,936,4819,5755,83.73588184187663,16.26411815812337,1.506959191075552,-7.758585835248999
TEXAS,TX,KARNES,48255,5252,1234,3968,5202,76.27835447904653,23.72164552095348,4198,1145,2965,4110,72.14111922141119,27.85888077858881,5.734919699454055,-14.850687256664807
TEXAS,TX,KAUFMAN,48257,56718,18405,37624,56029,67.15093969194524,32.84906030805476,41265,10278,29587,39865,74.21798570174339,25.782014298256616,-9.522012680589553,27.41075979573877
TEXAS,TX,KENDALL,48259,26452,6020,20083,26103,76.93751676052561,23.06248323947439,20120,3643,15700,19343,81.16631339502662,18.833686604973376,-5.210039063767713,22.453366264384588
TEXAS,TX,KENEDY,48261,194,65,127,192,66.14583333333333,33.854166666666664,186,99,84,183,45.90163934426229,54.09836065573771,44.103422619047606,-37.42108585858587
TEXAS,TX,KENT,48263,462,47,411,458,89.73799126637554,10.262008733624453,434,59,360,419,85.91885441527447,14.081145584725537,4.445050946142648,-27.12234475612464
TEXAS,TX,KERR,48265,27745,6524,20879,27403,76.19238769477795,23.807612305222055,23297,4681,17727,22408,79.11013923598715,20.88986076401285,-3.6882143924756416,13.967309663622274
TEXAS,TX,KIMBLE,48267,2292,284,1987,2271,87.49449581682079,12.505504183179216,1952,206,1697,1903,89.17498686284813,10.825013137151865,-1.8844870127224689,15.524147866941984
TEXAS,TX,KING,48269,159,8,151,159,94.96855345911949,5.031446540880503,159,5,149,154,96.75324675324676,3.2467532467532467,-1.8445823308429476,54.968553459119484
TEXAS,TX,KINNEY,48271,1603,446,1144,1590,71.9496855345912,28.050314465408807,1430,458,936,1394,67.14490674318508,32.85509325681492,7.155835080363393,-14.62415204196532
TEXAS,TX,KLEBERG,48273,10944,5314,5504,10818,50.87816601959697,49.12183398040303,9512,4716,4367,9083,48.078828580865355,51.921171419134645,5.822391105106295,-5.3915144096690515
TEXAS,TX,KNOX,48275,1456,265,1180,1445,81.66089965397924,18.33910034602076,1367,247,1078,1325,81.35849056603773,18.641509433962263,0.3716994819318309,-1.6222349859210117
TEXAS,TX,LA SALLE,48283,2406,1052,1335,2387,55.927943024717216,44.072056975282784,2059,1129,872,2001,43.578210894552726,56.421789105447274,28.339236229884346,-21.888232057094015
TEXAS,TX,LAMAR,48277,21442,4458,16760,21218,78.98953718540862,21.010462814591385,18611,3583,14561,18144,80.25242504409171,19.747574955908288,-1.5736444823807427,6.395154146789306
TEXAS,TX,LAMB,48279,4410,840,3521,4361,80.73836276083468,19.261637239165328,3995,771,3111,3882,80.13910355486863,19.860896445131374,0.7477737825651642,-3.0172817607784563
TEXAS,TX,LAMPASAS,48281,10399,2144,8086,10230,79.04203323558163,20.957966764418376,8205,1483,6385,7868,81.1514997458058,18.848500254194203,-2.599417776420321,11.191694202591918
TEXAS,TX,LAVACA,48285,10197,1333,8804,10137,86.85015290519878,13.149847094801224,8661,1170,7347,8517,86.26276858048608,13.737231419513913,0.6809244989217422,-4.275856661177757
TEXAS,TX,LEE,48287,8087,1750,6255,8005,78.13866333541536,21.861336664584634,6535,1372,4997,6369,78.45815669649866,21.541843303501334,-0.40721497233131565,1.4831291667197766
TEXAS,TX,LEON,48289,8674,1072,7523,8595,87.52763234438628,12.472367655613729,7439,909,6391,7300,87.54794520547945,12.452054794520548,-0.023201984975773637,0.16312858743698921
TEXAS,TX,LIBERTY,48291,29334,5785,23302,29087,80.11138996802696,19.888610031973048,24267,4862,18892,23754,79.53186831691505,20.468131683084955,0.7286659591632549,-2.8313363431740513
TEXAS,TX,LIMESTONE,48293,9095,2213,6789,9002,75.41657409464564,24.583425905354364,7739,1778,5796,7574,76.52495378927911,23.475046210720887,-1.4483898908133064,4.721522951155199
TEXAS,TX,LIPSCOMB,48295,1353,131,1205,1336,90.19461077844312,9.805389221556887,1332,135,1159,1294,89.56723338485317,10.432766615146832,0.7004541391763652,-6.01352849855844
TEXAS,TX,LIVE OAK,48297,5054,819,4199,5018,83.67875647668394,16.321243523316063,4302,742,3464,4206,82.3585354255825,17.641464574417498,1.6030166688604686,-7.483624987779825
TEXAS,TX,LLANO,48299,12660,2465,10079,12544,80.34917091836735,19.650829081632654,10447,1825,8299,10124,81.97352824970368,18.026471750296327,-1.981563275388476,9.010955409561072
TEXAS,TX,LOVING,48301,66,4,60,64,93.75,6.25,65,4,58,62,93.54838709677419,6.451612903225806,0.21551724137931494,-3.124999999999989
TEXAS,TX,LUBBOCK,48303,120817,40017,78861,118878,66.33775803765205,33.662241962347956,99013,28023,65651,93674,70.08454854068364,29.91545145931635,-5.346100647072872,12.5245995639647
TEXAS,TX,LYNN,48305,2293,428,1853,2281,81.23629986847874,18.76370013152126,2009,403,1546,1949,79.3227296049256,20.677270395074398,2.4123857979722274,-9.2544626393674
TEXAS,TX,MADISON,48313,5298,1088,4169,5257,79.30378542895187,20.696214571048127,4289,881,3351,4232,79.18241965973534,20.81758034026465,0.15327363035642083,-0.5829965213670074
TEXAS,TX,MARION,48315,4864,1339,3470,4809,72.15637346641714,27.843626533582867,4238,1165,2983,4148,71.91417550626808,28.08582449373192,0.33678750878252117,-0.8623494752774907
TEXAS,TX,MARTIN,48317,2160,288,1857,2145,86.57342657342657,13.426573426573427,1762,266,1455,1721,84.54386984311446,15.456130156885532,2.4005959676062893,-13.13107944686892
TEXAS,TX,MASON,48319,2474,457,1991,2448,81.33169934640523,18.66830065359477,2057,354,1656,2010,82.38805970149254,17.611940298507463,-1.2821765179501732,5.997978287360128
TEXAS,TX,MATAGORDA,48321,13727,3733,9845,13578,72.50699661216674,27.49300338783326,12196,3500,8366,11866,70.50396089667959,29.49603910332041,2.8410257948805473,-6.790863371420153
TEXAS,TX,MAVERICK,48323,15346,8332,6881,15213,45.2310523894038,54.7689476105962,13588,10397,2816,13213,21.312343903731175,78.68765609626882,112.22936620070753,-30.39702752920962
TEXAS,TX,MCCULLOCH,48307,3436,490,2904,3394,85.56275780789629,14.437242192103712,3103,482,2552,3034,84.11338167435729,15.886618325642717,1.7231219393249786,-9.123251429787016
TEXAS,TX,MCLENNAN,48309,97872,36688,59543,96231,61.8750714426744,38.1249285573256,79075,27063,48260,75323,64.07073536635556,35.929264633644436,-3.42693729223863,6.111073928368493
TEXAS,TX,MCMULLEN,48311,516,53,460,513,89.66861598440546,10.331384015594542,499,40,454,494,91.90283400809717,8.097165991902834,-2.4310654266601395,27.59259259259259
TEXAS,TX,MEDINA,48325,22657,6773,15642,22415,69.78362703546732,30.216372964532678,17246,4634,12085,16719,72.28303128177522,27.716968718224773,-3.4578022005810394,9.017595941739721
TEXAS,TX,MENARD,48327,1028,197,823,1020,80.68627450980392,19.313725490196077,864,154,682,836,81.57894736842105,18.42105263157895,-1.0942441492726163,4.845938375350123
TEXAS,TX,MIDLAND,48329,58859,12329,45624,57953,78.72586406225734,21.274135937742653,49212,10025,36973,46998,78.66930507681178,21.330694923188222,0.07189460411571869,-0.26515303720408
TEXAS,TX,MILAM,48331,10578,2496,7984,10480,76.18320610687023,23.81679389312977,8664,2051,6364,8415,75.62685680332739,24.373143196672608,0.7356504382955764,-2.2826325642676615
TEXAS,TX,MILLS,48333,2505,271,2217,2488,89.10771704180064,10.892282958199356,2245,243,1951,2194,88.92433910665451,11.075660893345487,0.20621793424429047,-1.6556839082741193
TEXAS,TX,MITCHELL,48335,2579,397,2170,2567,84.53447604207246,15.465523957927543,2196,354,1780,2134,83.41143392689784,16.588566073102154,1.3463886931363023,-6.769977044583674
TEXAS,TX,MONTAGUE,48337,9819,1097,8615,9712,88.70469522240528,11.295304777594728,8604,885,7526,8411,89.47806443942456,10.521935560575438,-0.8643115179842065,7.350066084010454
TEXAS,TX,MONTGOMERY,48339,271543,74377,193382,267759,72.22240895730863,27.777591042691377,204632,45835,150314,196149,76.63255994167699,23.36744005832301,-5.75493104722693,18.873060007262367
TEXAS,TX,MOORE,48341,5508,1062,4359,5421,80.40951853901494,19.590481460985057,5284,1098,3977,5075,78.36453201970443,21.635467980295566,2.6095817413881894,-9.452009640711145
TEXAS,TX,MORRIS,48343,5587,1669,3872,5541,69.8790831979787,30.120916802021295,4973,1425,3446,4871,70.7452268528023,29.2547731471977,-1.2243139125495572,2.960691749225086
TEXAS,TX,MOTLEY,48345,652,46,604,650,92.92307692307692,7.076923076923077,615,40,566,606,93.3993399339934,6.600660066006601,-0.5099211742321308,7.215384615384601
TEXAS,TX,"NACOGDOCHES",48347,26785,9000,17378,26378,65.8806581241944,34.119341875805596,22622,6846,14771,21617,68.33048064023686,31.66951935976315,-3.585255793737041,7.73558476910452
TEXAS,TX,"NAVARRO",48349,19123,5101,13800,18901,73.01200994656368,26.987990053436327,16433,4002,11994,15996,74.98124531132783,25.018754688672168,-2.6263038931771954,7.871036705339196
TEXAS,TX,NEWTON,48351,6094,1173,4882,6055,80.62758051197358,19.372419488026424,5534,1156,4288,5444,78.76561351947097,21.23438648052902,2.3639338402948074,-8.768640404138528
TEXAS,TX,NOLAN,48353,5357,1162,4131,5293,78.04647647836765,21.953523521632345,4857,1029,3552,4581,77.53765553372627,22.462344466273738,0.6562243095163733,-2.2652174415959347
TEXAS,TX,NUECES,48355,127322,60925,64617,125542,51.47042424049322,48.52957575950678,104405,49198,50766,99964,50.78428234164299,49.21571765835701,1.351091060486631,-1.3941519731831442
TEXAS,TX,OCHILTREE,48357,3156,302,2812,3114,90.30186255619782,9.698137443802183,3002,274,2628,2902,90.55823569951757,9.441764300482426,-0.2831030676993529,2.715309715014369
TEXAS,TX,OLDHAM,48359,1009,81,917,998,91.88376753507013,8.11623246492986,948,78,850,928,91.59482758620689,8.405172413793103,0.31545443828833175,-3.4376445198088468
TEXAS,TX,ORANGE,48361,35994,6357,29186,35543,82.11462172579692,17.885378274203077,32000,5735,25513,31248,81.64682539682539,18.353174603174605,0.5729510323247977,-2.5488578356935077
TEXAS,TX,PALO PINTO,48363,12489,2178,10179,12357,82.37436270939548,17.625637290604516,10270,1708,8284,9992,82.90632506004803,17.09367493995196,-0.6416426614824111,3.1120420419908257
TEXAS,TX,PANOLA,48365,11451,2057,9326,11383,81.92919265571466,18.07080734428534,10416,1835,8445,10280,82.14980544747081,17.85019455252918,-0.2685493782419446,1.2359125336530274
TEXAS,TX,PARKER,48367,76128,13017,62045,75062,82.6583357757587,17.341664224241295,56817,8344,46473,54817,84.77844464308518,15.221555356914825,-2.5007640518201035,13.928332667813415
TEXAS,TX,PARMER,48369,2650,488,2135,2623,81.3953488372093,18.6046511627907,2466,485,1915,2400,79.79166666666667,20.208333333333332,2.0098366628210407,-7.935746823303758
TEXAS,TX,PECOS,48371,4668,1382,3215,4597,69.93691537959539,30.063084620404613,4185,1554,2468,4022,61.36250621581303,38.63749378418697,13.97336858052376,-22.191939290046747
TEXAS,TX,POLK,48373,24186,5387,18573,23960,77.51669449081803,22.48330550918197,19852,4187,15176,19363,78.37628466663223,21.623715333367763,-1.0967477974624718,3.9752196260545825
TEXAS,TX,POTTER,48375,33337,9921,22820,32741,69.69854311108396,30.30145688891604,28651,7657,19630,27287,71.93901858027633,28.060981419723678,-3.1144092780362675,7.984309014999602
TEXAS,TX,PRESIDIO,48377,2217,1463,721,2184,33.01282051282051,66.98717948717949,2208,1458,652,2110,30.900473933649288,69.0995260663507,6.835968224005029,-3.0569624705427123
TEXAS,TX,RAINS,48379,6053,842,5155,5997,85.95964648991162,14.040353510088378,4701,628,3968,4596,86.33594429939077,13.664055700609225,-0.4358530071487343,2.75392473306717
TEXAS,TX,RANDALL,48381,64674,12802,50796,63598,79.87043617723828,20.12956382276172,54305,8367,43462,51829,83.8565281984989,16.14347180150109,-4.7534665539992975,24.691665276672325
TEXAS,TX,REAGAN,48383,1124,172,942,1114,84.56014362657092,15.439856373429084,904,167,709,876,80.93607305936074,19.06392694063927,4.477695087272382,-19.01009471183307
TEXAS,TX,REAL,48385,1982,320,1643,1963,83.6984207845135,16.301579215486502,1681,262,1382,1644,84.06326034063261,15.936739659367397,-0.43400595532547825,2.2892985887778883
TEXAS,TX,RED RIVER,48387,5806,1246,4517,5763,78.37931632830123,21.620683671698767,5161,1149,3926,5075,77.35960591133005,22.64039408866995,1.318143241499925,-4.50394287739665
TEXAS,TX,REEVES,48389,3689,1395,2254,3649,61.77034804055906,38.22965195944094,3184,1659,1417,3076,46.06631989596879,53.93368010403121,34.090042747183944,-29.117293895575447
TEXAS,TX,REFUGIO,48391,3366,1108,2210,3318,66.60638939119951,33.39361060880048,2948,1034,1830,2864,63.89664804469274,36.10335195530726,4.240819243931915,-7.5055118146957644
TEXAS,TX,ROBERTS,48393,550,17,529,546,96.88644688644689,3.1135531135531136,554,20,524,544,96.32352941176471,3.676470588235294,0.5844028744792062,-15.311355311355301
TEXAS,TX,ROBERTSON,48395,8099,2374,5646,8020,70.39900249376558,29.600997506234414,7035,2203,4668,6871,67.93770921263281,32.062290787367196,3.622867638102667,-7.6765983362066965
TEXAS,TX,ROCKWALL,48397,53891,16412,36726,53138,69.11438142195792,30.88561857804208,39948,9655,28451,38106,74.6627827638692,25.337217236130794,-7.4312812039953435,21.898226984450698
TEXAS,TX,RUNNELS,48399,4409,552,3807,4359,87.33654507914659,12.663454920853408,3782,453,3250,3703,87.76667566837699,12.233324331623008,-0.49008417597543597,3.516056450154892
TEXAS,TX,RUSK,48401,21377,4629,16534,21163,78.12691962387186,21.873080376128147,18994,3935,14675,18610,78.85545405695862,21.144545943041376,-0.9238859148037237,3.445495755970729
TEXAS,TX,SABINE,48403,5491,669,4784,5453,87.73152393178067,12.268476068219329,4651,614,3998,4612,86.68690372940156,13.31309627059844,1.2050496181521764,-7.846560868684782
TEXAS,TX,SAN AUGUSTINE,48405,4002,980,3007,3987,75.42011537496865,24.57988462503135,3569,910,2622,3532,74.23556058890148,25.76443941109853,1.5956702915290721,-4.597634620207991
TEXAS,TX,SAN JACINTO,48407,12640,2337,10161,12498,81.3010081613058,18.69899183869419,10343,2038,8059,10097,79.81578686738635,20.184213132613646,1.8608114412091759,-7.358331405645114
TEXAS,TX,SAN PATRICIO,48409,25891,8988,16516,25504,64.75846925972397,35.24153074027603,21656,7871,13030,20901,62.341514760059326,37.658485239940674,3.876958249999274,-6.418087409159023
TEXAS,TX,SAN SABA,48411,2602,287,2308,2595,88.94026974951831,11.059730250481696,2357,293,2025,2318,87.35979292493529,12.64020707506471,1.8091581626584752,-12.503567506428082
TEXAS,TX,SCHLEICHER,48413,1159,211,940,1151,81.66811468288445,18.331885317115553,1059,208,821,1029,79.78620019436346,20.21379980563654,2.358696721909981,-9.310048118692771
TEXAS,TX,SCURRY,48415,5870,818,4983,5801,85.8989829339769,14.101017066023099,5289,733,4410,5143,85.74761812171884,14.25238187828116,0.17652363479436772,-1.0620316909184302
TEXAS,TX,SHACKELFORD,48417,1628,130,1484,1614,91.9454770755886,8.0545229244114,1504,103,1378,1481,93.04523970290344,6.9547602970965565,-1.1819654942331503,15.813091757798858
TEXAS,TX,SHELBY,48419,10087,2068,7975,10043,79.40854326396494,20.59145673603505,9086,1758,7179,8937,80.32896945283652,19.67103054716348,-1.1458209848091983,4.679094908956327
TEXAS,TX,SHERMAN,48421,992,91,886,977,90.68577277379734,9.31422722620266,935,96,807,903,89.3687707641196,10.631229235880399,1.473671393728626,-12.388050153531227
TEXAS,TX,SMITH,48423,100089,29615,69080,98695,69.99341405339683,30.00658594660317,84768,22300,58930,81230,72.54708851409578,27.452911485904224,-3.5200233572471595,9.302016880832987
TEXAS,TX,SOMERVELL,48425,4947,768,4105,4873,84.23968807715985,15.76031192284014,3897,541,3206,3747,85.56178275954096,14.438217240459034,-1.5451930052657548,9.156910859301304
TEXAS,TX,STARR,48427,17525,9123,8247,17370,47.47841105354059,52.52158894645941,11740,9289,2224,11513,19.31729349431078,80.68270650568923,145.78190038642666,-34.903536059792536
TEXAS,TX,STEPHENS,48429,3800,397,3385,3782,89.50290851401375,10.497091485986251,3461,348,3034,3382,89.71023063276168,10.289769367238321,-0.23110197943490007,2.014837372429601
TEXAS,TX,STERLING,48431,639,51,584,635,91.96850393700787,8.031496062992126,633,70,549,619,88.69143780290791,11.308562197092083,3.694906989085367,-28.97862767154106
TEXAS,TX,STONEWALL,48433,736,116,615,731,84.1313269493844,15.868673050615595,701,135,555,690,80.43478260869566,19.565217391304348,4.595703774910342,-18.89344885240918
TEXAS,TX,SUTTON,48435,1557,322,1222,1544,79.14507772020725,20.854922279792746,1416,313,1075,1388,77.44956772334294,22.55043227665706,2.1891794192071323,-7.518747206542065
TEXAS,TX,SWISHER,48437,2355,478,1845,2323,79.42315970727508,20.576840292724924,2204,462,1671,2133,78.34036568213783,21.659634317862167,1.3821661613511393,-4.999133453718052
TEXAS,TX,TARRANT,48439,834697,411567,409741,821308,49.88883585695013,50.11116414304987,668514,288392,345921,634313,54.53474861779595,45.46525138220405,-8.519178832942764,10.21860128252654
TEXAS,TX,TAYLOR,48441,55135,14588,39547,54135,73.05255380068348,26.947446199316524,45759,10085,33250,43335,76.72781816083997,23.272181839160034,-4.790002437515229,15.792521670538573
TEXAS,TX,TERRELL,48443,458,119,334,453,73.73068432671081,26.26931567328918,438,140,288,428,67.28971962616822,32.71028037383178,9.571989207750796,-19.69094922737308
TEXAS,TX,TERRY,48445,3612,757,2812,3569,78.78957691230036,21.210423087699635,3355,753,2459,3212,76.55666251556663,23.443337484433375,2.9166820017522355,-9.524729139852283
TEXAS,TX,THROCKMORTON,48447,894,82,806,888,90.76576576576576,9.234234234234235,808,84,715,799,89.48685857321652,10.513141426783479,1.4291564291564196,-12.164843414843407
TEXAS,TX,TITUS,48449,10541,2856,7570,10426,72.60694417801649,27.393055821983502,9419,2597,6511,9108,71.48660518225735,28.513394817742643,1.567201286035047,-3.929167336686279
TEXAS,TX,TOM GREEN,48451,45210,12239,32313,44552,72.52873047225714,27.471269527742862,38479,9173,27494,36667,74.98295470041181,25.017045299588187,-3.2730428374826315,9.81020819511038
TEXAS,TX,TRAVIS,48453,608575,435860,161337,597197,27.015708384335486,72.98429161566452,468720,308260,127209,435469,29.211953089657356,70.78804691034264,-7.518308339675728,3.102564346920822
TEXAS,TX,TRINITY,48455,6938,1323,5579,6902,80.8316430020284,19.168356997971603,5985,1154,4737,5891,80.41079612968936,19.589203870310644,0.5233711051191303,-2.1483612867844837
TEXAS,TX,TYLER,48457,9660,1403,8194,9597,85.38084818172345,14.619151818276546,8016,1248,6624,7872,84.14634146341463,15.853658536585366,1.4670949405988898,-7.786888530871017
TEXAS,TX,UPSHUR,48459,18892,2877,15809,18686,84.60344643048272,15.396553569517286,16013,2380,13209,15589,84.73282442748092,15.267175572519085,-0.1526893478086877,0.8474258803382151
TEXAS,TX,UPTON,48461,1368,170,1178,1348,87.3887240356083,12.611275964391691,1347,286,1007,1293,77.88089713843775,22.119102861562258,12.208163036784047,-42.98468593720819
TEXAS,TX,UVALDE,48463,10344,4073,6174,10247,60.25178100907583,39.74821899092417,8964,3867,4835,8702,55.56193978395771,44.43806021604229,8.440744227709995,-10.553658738292693
TEXAS,TX,VAL VERDE,48465,15280,6771,8284,15055,55.02490866821654,44.97509133178346,13617,6964,5890,12854,45.82231212074063,54.17768787925937,20.08322173535746,-16.985952903683998
TEXAS,TX,VAN ZANDT,48467,26029,3516,22270,25786,86.36469402001086,13.635305979989141,21890,2799,18473,21272,86.84185784129372,13.15814215870628,-0.5494629354370728,3.626376851135782
TEXAS,TX,VICTORIA,48469,34188,10380,23358,33738,69.2335052463098,30.7664947536902,31123,8866,21275,30141,70.5849175541621,29.415082445837896,-1.9145907577427068,4.594283596997095
TEXAS,TX,WALKER,48471,23612,7884,15375,23259,66.10344382819554,33.89655617180446,19796,6091,12884,18975,67.89986824769433,32.100131752305664,-2.6456964731441768,5.59631478574778
TEXAS,TX,WALLER,48473,22734,8191,14260,22451,63.51610173266224,36.48389826733776,16784,5748,10531,16279,64.69070581731064,35.30929418268936,-1.8157230931527213,3.326614456157162
TEXAS,TX,WARD,48475,4060,764,3241,4005,80.92384519350811,19.076154806491886,3445,783,2547,3330,76.48648648648648,23.513513513513512,5.801493715894002,-18.871525535609212
TEXAS,TX,WASHINGTON,48477,17427,4261,12959,17220,75.25551684088269,24.744483159117305,14828,3382,10945,14327,76.39422070217073,23.605779297829272,-1.4905628342324118,4.823835074119942
TEXAS,TX,WEBB,48479,68397,41820,25898,67718,38.24389379485513,61.75610620514487,56905,42307,12947,55254,23.43178774387375,76.56821225612626,63.21372578519544,-19.344980919018738
TEXAS,TX,WHARTON,48481,16761,4694,11926,16620,71.7569193742479,28.243080625752107,14732,4238,10149,14387,70.54285118509766,29.457148814902343,1.7210364604694606,-4.121472165480045
TEXAS,TX,WHEELER,48483,2337,168,2159,2327,92.7804039535883,7.219596046411689,2306,194,2087,2281,91.49495835160018,8.505041648399825,1.4049359933564487,-15.113924835747106
TEXAS,TX,WICHITA,48485,46040,13161,32069,45230,70.90205615741765,29.097943842582357,38119,8770,27631,36401,75.9072552951842,24.0927447048158,-6.593834961233402,20.77471537215969
TEXAS,TX,WILBARGER,48487,4524,956,3524,4480,78.66071428571429,21.339285714285715,4105,809,3166,3975,79.64779874213836,20.352201257861637,-1.2393116595974973,4.850013243863671
TEXAS,TX,WILLACY,48489,5549,3108,2441,5549,43.989908091548024,56.010091908451976,5095,3422,1547,4969,31.133024753471524,68.86697524652848,41.296608472464214,-18.669156431005895
TEXAS,TX,WILLIAMSON,48491,289555,143795,139729,283524,49.282953118607246,50.717046881392754,203081,84468,104175,188643,55.223358407150016,44.776641592849984,-10.75705183438036,13.266750424380525
TEXAS,TX,WILSON,48493,25013,6350,18463,24813,74.408576149599,25.591423850401,19432,4790,13998,18788,74.50500319352778,25.494996806472216,-0.12942358203558157,0.378219478357833
TEXAS,TX,WINKLER,48495,2126,358,1753,2111,83.04121269540502,16.958787304594978,1876,420,1403,1823,76.96105320899616,23.03894679100384,7.900307016196262,-26.39078748505561
TEXAS,TX,WISE,48497,32365,4973,27032,32005,84.46180284330573,15.538197156694267,24776,3412,20670,24082,85.83174154970517,14.168258450294825,-1.5960746941224624,9.669069146398401
TEXAS,TX,WOOD,48499,22779,3509,19049,22558,84.44454295593582,15.55545704406419,18727,2630,15700,18330,85.6519367157665,14.348063284233497,-1.4096514406175986,8.41502951243216
TEXAS,TX,YOAKUM,48501,2631,420,2174,2594,83.80878951426368,16.191210485736313,2303,426,1797,2223,80.83670715249663,19.163292847503374,3.6766494658921234,-15.509246690629519
TEXAS,TX,YOUNG,48503,8239,1034,7110,8144,87.30353634577604,12.696463654223969,7707,876,6601,7477,88.28407115153136,11.715928848468637,-1.1106588005805995,8.369245139991577
TEXAS,TX,ZAPATA,48505,3874,1826,2033,3859,52.68204197978751,47.31795802021249,3142,2063,1029,3092,33.279430789133244,66.72056921086676,58.3021125379038,-29.08040416941493
TEXAS,TX,ZAVALA,48507,4379,2864,1490,4354,34.22140560404226,65.77859439595774,3396,2636,694,3330,20.84084084084084,79.15915915915916,64.20357444014515,-16.90336899144944
UTAH,UT,BEAVER,49001,3100,357,2695,3052,88.30275229357798,11.697247706422019,2491,264,1838,2102,87.44053282588011,12.559467174119886,0.9860638308492486,-6.8650959132610545
UTAH,UT,BOX ELDER,49003,27023,4473,21548,26021,82.81003804619345,17.18996195380654,19735,2282,12230,14512,84.27508269018743,15.724917309812568,-1.7384078392183588,9.316708095372729
UTAH,UT,CACHE,49005,58358,16650,38032,54682,69.55122343732856,30.448776562671444,46157,8563,21139,29702,71.17029156285771,28.82970843714228,-2.2749213049087946,5.615971209210224
UTAH,UT,CARBON,49007,9369,2392,6693,9085,73.67088607594937,26.329113924050635,7952,1717,5275,6992,75.44336384439359,24.55663615560641,-2.3494150818885284,7.21791762199302
UTAH,UT,DAGGETT,49009,619,111,496,607,81.71334431630972,18.28665568369028,474,77,331,408,81.12745098039215,18.872549019607842,0.7221887645147085,-3.1044737799268196
UTAH,UT,DAVIS,49011,169814,57411,104135,161546,64.46151560546222,35.538484394537775,138411,28776,62219,90995,68.37628441123138,31.623715588768615,-5.725331289171542,12.37921835838771
UTAH,UT,DUCHESNE,49013,8561,843,7512,8355,89.91023339317773,10.089766606822263,6942,500,5508,6008,91.67776298268974,8.322237017310252,-1.9279807141953764,21.238635547576322
UTAH,UT,EMERY,49015,4898,572,4207,4779,88.03096882192928,11.969031178070725,4289,380,3425,3805,90.01314060446781,9.986859395532194,-2.202091571550102,19.847799033050293
UTAH,UT,GARFIELD,49017,2732,514,2158,2672,80.76347305389221,19.236526946107784,2344,358,1606,1964,81.77189409368636,18.228105906313644,-1.2332122802962031,5.5322316261332105
UTAH,UT,GRAND,49019,5185,2806,2248,5054,44.4796201028888,55.5203798971112,4533,1960,1975,3935,50.19059720457433,49.80940279542567,-11.378579693738,11.465660660781918
UTAH,UT,IRON,49021,25104,4892,18989,23881,79.51509568276035,20.484904317239646,17654,2450,11561,14011,82.51373920491042,17.48626079508957,-3.6341142106084856,17.14856913830396
UTAH,UT,JUAB,49023,5865,645,5087,5732,88.74738311235171,11.25261688764829,4177,442,2827,3269,86.47904557968798,13.520954420312021,2.6229909424399622,-16.77646016804918
UTAH,UT,KANE,49025,4180,1083,2998,4081,73.46238666993384,26.53761333006616,3505,741,2265,3006,75.3493013972056,24.65069860279441,-2.504223253942117,7.654609541402002
UTAH,UT,MILLARD,49027,6190,624,5404,6028,89.64830789648308,10.351692103516921,5242,431,3860,4291,89.95572127709158,10.044278722908413,-0.34173855341738113,3.0605819401185785
UTAH,UT,MORGAN,49029,6606,1086,5181,6267,82.67113451412159,17.32886548587841,5192,577,3188,3765,84.6746347941567,15.325365205843294,-2.3661162341067077,13.073099747542827
UTAH,UT,PIUTE,49031,871,86,773,859,89.988358556461,10.011641443538998,729,47,626,673,93.01634472511144,6.983655274888559,-3.255326983229634,43.35818492556906
UTAH,UT,RICH,49033,1369,180,1157,1337,86.53702318623785,13.462976813762154,1109,104,797,901,88.45726970033296,11.542730299667037,-2.1708182047674995,16.635981819227897
UTAH,UT,SALT LAKE,49035,546581,289906,230174,520080,44.25742193508691,55.74257806491309,418868,175863,138043,313906,43.975903614457835,56.024096385542165,0.6401649482798089,-0.5024950669293204
UTAH,UT,SAN JUAN,49037,6877,3113,3535,6648,53.17388688327316,46.82611311672684,5447,2042,2645,4687,56.43268615318967,43.56731384681033,-5.7746662299049785,7.479917814935688
UTAH,UT,SANPETE,49039,12625,1794,10459,12253,85.35868766832613,14.641312331673875,10164,1061,6673,7734,86.28135505559865,13.718644944401344,-1.069370533967584,6.725645215047837
UTAH,UT,SEVIER,49041,10362,1084,9052,10136,89.30544593528019,10.69455406471981,8654,695,6740,7435,90.6523201075992,9.347679892400807,-1.4857580817791982,14.408646721139263
UTAH,UT,SUMMIT,49043,26086,15244,10252,25496,40.21022905553812,59.78977094446188,20641,10503,7333,17836,41.11347835837632,58.88652164162368,-2.1969663937572714,1.5338812306409766
UTAH,UT,TOOELE,49045,31506,8943,21014,29957,70.14721100243682,29.852788997563174,21829,4573,11169,15742,70.95032397408207,29.049676025917925,-1.1319370041757981,2.764619374511157
UTAH,UT,UINTAH,49047,15303,1663,13261,14924,88.85687483248459,11.14312516751541,12797,995,9810,10805,90.7913003239241,9.208699676075891,-2.13062868858348,21.006499934677404
UTAH,UT,UTAH,49049,284286,76033,192812,268845,71.71864829176663,28.28135170823337,201551,28522,102182,130704,78.1781735830579,21.8218264169421,-8.262568687958094,29.60121287682962
UTAH,UT,WASATCH,49051,17790,6187,10795,16982,63.56730655988694,36.43269344011306,12120,3063,6115,9178,66.62671606014382,33.37328393985618,-4.591865967842635,9.167241395154324
UTAH,UT,WASHINGTON,49053,91070,20530,67294,87824,76.62370194935325,23.37629805064675,61963,10288,42650,52938,80.56594506781518,19.43405493218482,-4.893187953227141,20.285231940623795
UTAH,UT,WAYNE,49055,1621,365,1229,1594,77.10163111668759,22.898368883312422,1421,271,966,1237,78.09215844785773,21.90784155214228,-1.2684081870160124,4.5213369323153785
UTAH,UT,WEBER,49057,111403,40695,65949,106644,61.84032856982109,38.15967143017891,85039,23131,40235,63366,63.49619669854496,36.50380330145504,-2.607822538703042,4.5361523429474415
VERMONT,VT,ADDISON,50001,22611,15089,6567,21656,30.32415958625785,69.67584041374215,19031,11219,5297,16516,32.07193024945507,67.92806975054492,-5.449533749927382,2.572972660073569
VERMONT,VT,BENNINGTON,50003,19357,11858,6724,18582,36.18555591432569,63.81444408567431,17381,9539,5925,15464,38.31479565442318,61.68520434557682,-5.5572258803151975,3.45178355601925
VERMONT,VT,CALEDONIA,50005,15158,8529,5924,14453,40.988030166747386,59.011969833252614,14075,6445,5534,11979,46.197512313214794,53.802487686785206,-11.27654257906272,9.682604597755319
VERMONT,VT,CHITTENDEN,50007,96755,72938,20104,93042,21.60744609961093,78.39255390038907,83418,54814,18601,73415,25.336784035959955,74.66321596404005,-14.719065888772842,4.994879859106494
VERMONT,VT,ESSEX,50009,4237,1890,2164,4054,53.37937839171189,46.62062160828811,2925,1019,1506,2525,59.64356435643565,40.35643564356435,-10.502702231691563,15.522148734963181
VERMONT,VT,FRANKLIN,50011,26072,13612,11274,24886,45.302579763722576,54.697420236277424,21411,9351,8752,18103,48.345578080981056,51.654421919018944,-6.294264001066074,5.891070317327585
VERMONT,VT,GRAND ISLE,50013,5782,3346,2194,5540,39.6028880866426,60.3971119133574,4110,2094,1487,3581,41.52471376710416,58.47528623289584,-4.628149133646831,3.2865605356890315
VERMONT,VT,LAMOILLE,50015,15679,10773,4171,14944,27.910867237687366,72.08913276231263,12762,7241,3570,10811,33.021922116362965,66.97807788363704,-15.477763107384291,7.630936927684262
VERMONT,VT,ORANGE,50017,14876,8351,5782,14133,40.911342248637936,59.088657751362064,14649,7541,5007,12548,39.90277335033471,60.09722664966529,2.527565914900909,-1.6782286879603259
VERMONT,VT,ORLEANS,50019,15442,7757,7086,14843,47.73967526780301,52.26032473219699,12047,5185,5159,10344,49.87432327919567,50.12567672080433,-4.28005408603328,4.258591905466869
VERMONT,VT,RUTLAND,50021,34772,18746,14625,33371,43.82547721075185,56.17452278924815,29619,13635,12479,26114,47.78662786244926,52.21337213755074,-8.289244981042243,7.586467775462125
VERMONT,VT,WASHINGTON,50023,35325,25101,8707,33808,25.75425934690014,74.24574065309986,31086,18594,7993,26587,30.063564900139166,69.93643509986083,-14.333980575999739,6.1617460871230545
VERMONT,VT,WINDHAM,50025,28452,20057,7251,27308,26.552658561593674,73.44734143840633,22635,14340,5454,19794,27.553804183085784,72.44619581691421,-3.633420687901512,1.381916069164224
VERMONT,VT,WINDSOR,50027,36308,24779,10135,34914,29.028469954745947,70.97153004525406,29928,17556,8605,26161,32.89247352929934,67.10752647070066,-11.747379141649184,5.757928771581877
VIRGINIA,VA,ACCOMACK,51001,16962,7578,9172,16750,54.75820895522388,45.24179104477612,15818,6740,8583,15323,56.013835410820334,43.986164589179666,-2.241636278586101,2.854594091855267
VIRGINIA,VA,ALBEMARLE,51003,64657,42466,20804,63270,32.881302354986566,67.11869764501344,56726,33345,19259,52604,36.611284312980004,63.388715687019996,-10.188066406266516,5.8842996226806665
VIRGINIA,VA,ALEXANDRIA CITY,51510,82521,66240,14544,80784,18.003565062388592,81.99643493761141,NA,NA,NA,NA,NA,NA,NA,NA
VIRGINIA,VA,ALLEGHANY,51005,8203,2243,5859,8102,72.31547765983707,27.68452234016292,7325,2166,4874,7040,69.23295454545455,30.767045454545453,4.452392844737996,-10.018911692175914
VIRGINIA,VA,AMELIA,51007,7894,2411,5390,7801,69.09370593513653,30.90629406486348,7040,2128,4708,6836,68.87068461088356,31.129315389116442,0.32382620488387026,-0.7164350435118649
VIRGINIA,VA,AMHERST,51009,17005,5672,11041,16713,66.06234667624005,33.937653323759946,15396,5057,9719,14776,65.77558202490525,34.224417975094745,0.43597432741260267,-0.8378948958123411
VIRGINIA,VA,APPOMATTOX,51011,9268,2418,6702,9120,73.48684210526316,26.513157894736842,8011,2023,5715,7738,73.85629361592143,26.143706384078573,-0.5002302343785958,1.4131565939069057
VIRGINIA,VA,ARLINGTON,51013,130739,105344,22318,127662,17.48210117341104,82.51789882658896,121356,92016,20186,112202,17.990766653000836,82.00923334699917,-2.8273696691238692,0.6202539138946861
VIRGINIA,VA,AUGUSTA,51015,42278,10840,30714,41554,73.91346200125139,26.086537998748618,36343,8177,26163,34340,76.18811881188118,23.81188118811881,-2.9855794395530766,9.552612801397519
VIRGINIA,VA,BATH,51017,2501,646,1834,2480,73.95161290322581,26.048387096774192,2253,603,1548,2151,71.96652719665272,28.03347280334728,2.7583458364591085,-7.081126624939815
VIRGINIA,VA,BEDFORD,51019,48669,12176,35600,47776,74.51440053583389,25.485599464166107,42525,9768,30659,40427,75.83793009622282,24.16206990377718,-1.745207917343794,5.477715964152652
VIRGINIA,VA,BEDFORD,51019,48669,12176,35600,47776,74.51440053583389,25.485599464166107,0,NA,NA,NA,NA,NA,NA,NA
VIRGINIA,VA,BLAND,51021,3479,532,2903,3435,84.51237263464337,15.487627365356623,3139,453,2573,3026,85.02974223397224,14.970257766027759,-0.6084572124248622,3.455983239666982
VIRGINIA,VA,BOTETOURT,51023,21123,5700,15099,20799,72.59483629020626,27.40516370979374,18739,4494,13375,17869,74.8502994011976,25.149700598802394,-3.0132987162844294,8.968150941322728
VIRGINIA,VA,BRISTOL CITY,51520,7814,2313,5347,7660,69.8041775456919,30.195822454308093,NA,NA,NA,NA,NA,NA,NA,NA
VIRGINIA,VA,BRUNSWICK,51025,7948,4552,3357,7909,42.44531546339613,57.55468453660387,7669,4481,3046,7527,40.46764979407467,59.53235020592533,4.887028723894504,-3.3220016721675183
VIRGINIA,VA,BUCHANAN,51027,9957,1587,8311,9898,83.96645787027683,16.033542129723177,9247,1721,7296,9017,80.91382943329268,19.08617056670733,3.7726905998199056,-15.993928306964623
VIRGINIA,VA,BUCKINGHAM,51029,8129,3471,4544,8015,56.69369931378665,43.30630068621335,7295,3128,3950,7078,55.80672506357728,44.19327493642272,1.5893680361979579,-2.0070344446873167
VIRGINIA,VA,BUENA VISTA CITY,51530,2776,825,1863,2688,69.30803571428571,30.691964285714285,NA,NA,NA,NA,NA,NA,NA,NA
VIRGINIA,VA,CAMPBELL,51031,29901,8070,21245,29315,72.47143100801637,27.528568991983626,27535,6664,19551,26215,74.57943925233644,25.42056074766355,-2.82652734514095,8.292532431700295
VIRGINIA,VA,CAROLINE,51033,16288,7657,8336,15993,52.1228037266304,47.8771962733696,14863,6432,7147,13579,52.63274173355917,47.36725826644083,-0.9688608081832584,1.0765622195406888
VIRGINIA,VA,CARROLL,51035,15657,2842,12659,15501,81.66569898716212,18.33430101283788,13668,2559,10663,13222,80.64589320828921,19.354106791710784,1.2645476890422502,-5.2691957828282625
VIRGINIA,VA,CHARLES CITY,51036,4441,2624,1761,4385,40.15963511972634,59.84036488027366,4107,2496,1476,3972,37.16012084592145,62.83987915407855,8.071863614873331,-4.773265503026048
VIRGINIA,VA,CHARLOTTE,51037,6191,2317,3815,6132,62.21461187214612,37.78538812785388,5808,2155,3479,5634,61.75008874689386,38.24991125310614,0.7522630892990101,-1.2144423608683286
VIRGINIA,VA,CHARLOTTESVILLE CITY,51540,24213,20696,3094,23790,13.005464480874316,86.99453551912568,NA,NA,NA,NA,NA,NA,NA,NA
VIRGINIA,VA,CHESAPEAKE CITY,51550,127246,66377,58180,124557,46.709538604815464,53.290461395184536,NA,NA,NA,NA,NA,NA,NA,NA
VIRGINIA,VA,CHESTERFIELD,51041,203955,106935,93326,200261,46.60218414968466,53.39781585031534,176461,81074,85045,166119,51.19522751762291,48.80477248237709,-8.971624095931963,9.411053743968889
VIRGINIA,VA,CLARKE,51043,9337,3920,5192,9112,56.97980684811238,43.02019315188762,8213,3051,4661,7712,60.43827800829875,39.56172199170125,-5.722319156266309,8.741963155475997
VIRGINIA,VA,COLONIAL HEIGHTS CITY,51570,9160,2972,6007,8979,66.90054571778595,33.099454282214055,NA,NA,NA,NA,NA,NA,NA,NA
VIRGINIA,VA,COVINGTON CITY,51580,2603,964,1580,2544,62.106918238993714,37.893081761006286,NA,NA,NA,NA,NA,NA,NA,NA
VIRGINIA,VA,CRAIG,51045,3170,587,2536,3123,81.20397054114633,18.796029458853667,2794,541,2140,2681,79.82096232748974,20.17903767251026,1.7326378601931536,-6.853687653998741
VIRGINIA,VA,CULPEPER,51047,27116,10617,16012,26629,60.1299335311127,39.8700664688873,22218,7759,13349,21108,63.241425052112945,36.758574947887055,-4.92002120198316,8.464668517241037
VIRGINIA,VA,CUMBERLAND,51049,5313,2227,3019,5246,57.54860846359131,42.45139153640869,4906,2036,2697,4733,56.98288611874076,43.01711388125924,0.9927934216453993,-1.315109949989024
VIRGINIA,VA,DANVILLE CITY,51590,19456,11710,7428,19138,38.812833106907725,61.187166893092275,NA,NA,NA,NA,NA,NA,NA,NA
VIRGINIA,VA,DICKENSON,51051,7307,1503,5748,7251,79.27182457592056,20.72817542407944,6440,1335,4932,6267,78.69794159885113,21.302058401148876,0.7292223473832404,-2.694025930557431
VIRGINIA,VA,DINWIDDIE,51053,15092,6224,8695,14919,58.281386151886856,41.718613848113144,13575,5765,7447,13212,56.36542537087496,43.63457462912504,3.399177365211381,-4.3909234759287425
VIRGINIA,VA,EMPORIA CITY,51595,2384,1612,754,2366,31.86813186813187,68.13186813186813,NA,NA,NA,NA,NA,NA,NA,NA
VIRGINIA,VA,ESSEX,51057,6178,3038,3075,6113,50.30263373139211,49.69736626860789,5408,2542,2657,5199,51.10598191959992,48.89401808040008,-1.5719259429779364,1.6430398231677357
VIRGINIA,VA,FAIRFAX,51059,601243,419943,168401,588344,28.622880491685137,71.37711950831486,551183,355133,157710,512843,30.752101520348333,69.24789847965167,-6.923822839405991,3.0747807159647866
VIRGINIA,VA,FAIRFAX,51059,601243,419943,168401,588344,28.622880491685137,71.37711950831486,12030,7367,3702,11069,33.44475562381425,66.55524437618574,-14.417432695174814,7.244921384218439
VIRGINIA,VA,FAIRFAX CITY,51600,13487,9174,4007,13181,30.39981791973295,69.60018208026705,NA,NA,NA,NA,NA,NA,NA,NA
VIRGINIA,VA,FALLS CHURCH CITY,51610,8819,7146,1490,8636,17.253358036127835,82.74664196387216,NA,NA,NA,NA,NA,NA,NA,NA
VIRGINIA,VA,FAUQUIER,51061,43671,17565,25106,42671,58.83621194722411,41.16378805277589,37467,12971,22127,35098,63.04347826086956,36.95652173913044,-6.6735948423341735,11.38436767221711
VIRGINIA,VA,FLOYD,51063,9412,3004,6225,9229,67.45042799869975,32.54957200130025,8051,2300,5293,7593,69.70894244699065,30.291057553009352,-3.2399206888102716,7.456043567770765
VIRGINIA,VA,FLUVANNA,51065,15846,7414,8155,15569,52.37972894855161,47.62027105144839,13597,5760,7025,12785,54.94720375439969,45.05279624560031,-4.672621408223154,5.698813436244388
VIRGINIA,VA,FRANKLIN,51067,29704,8381,20895,29276,71.37245525344993,28.627544746550075,26971,7257,18569,25826,71.90041043909238,28.099589560907614,-0.7342867480425452,1.8788715205184214
VIRGINIA,VA,FRANKLIN,51067,29704,8381,20895,29276,71.37245525344993,28.627544746550075,4070,2519,1421,3940,36.065989847715734,63.934010152284266,97.89407016086751,-55.22329245676567
VIRGINIA,VA,FRANKLIN CITY,51620,4064,2525,1487,4012,37.06380857427717,62.93619142572283,NA,NA,NA,NA,NA,NA,NA,NA
VIRGINIA,VA,FREDERICK,51069,48718,17207,30558,47765,63.97571443525594,36.02428556474406,40440,11932,26083,38015,68.61238984611337,31.387610153886623,-6.757781533709517,14.772311074735622
VIRGINIA,VA,FREDERICKSBURG CITY,51630,12877,8517,4037,12554,32.157081408316074,67.84291859168393,NA,NA,NA,NA,NA,NA,NA,NA
VIRGINIA,VA,GALAX CITY,51640,2639,777,1838,2615,70.2868068833652,29.7131931166348,NA,NA,NA,NA,NA,NA,NA,NA
VIRGINIA,VA,GILES,51071,9178,2156,6876,9032,76.12931798051373,23.87068201948627,8212,1950,5910,7860,75.19083969465649,24.80916030534351,1.2481284816984628,-3.7827893983784167
VIRGINIA,VA,GLOUCESTER,51073,22284,6964,14875,21839,68.11209304455332,31.887906955446677,19619,5404,13096,18500,70.78918918918919,29.21081081081081,-3.781786704013712,9.164744388557278
VIRGINIA,VA,GOOCHLAND,51075,16952,6685,9966,16651,59.85226112545793,40.14773887454207,14037,4889,8384,13273,63.16582535975288,36.83417464024712,-5.245817996397529,8.995896519083013
VIRGINIA,VA,GRAYSON,51077,8131,1535,6529,8064,80.96478174603175,19.035218253968253,7285,1407,5592,6999,79.89712816116588,20.10287183883412,1.3362853076674064,-5.3109505618167745
VIRGINIA,VA,GREENE,51079,11313,4163,6866,11029,62.25405748481277,37.74594251518723,9608,2924,5945,8869,67.03123238245574,32.96876761754425,-7.126789599191841,14.490001425169496
VIRGINIA,VA,GREENSVILLE,51081,4574,2627,1914,4541,42.14930632019379,57.85069367980621,4363,2558,1737,4295,40.442374854481955,59.557625145518045,4.220650918383595,-2.866016671318339
VIRGINIA,VA,HALIFAX,51083,18248,7666,10418,18084,57.608936076089364,42.391063923910636,17001,6897,9704,16601,58.454309981326425,41.545690018673575,-1.4462131286933633,2.0348053067769323
VIRGINIA,VA,HAMPTON CITY,51650,65957,46220,18430,64650,28.507347254447023,71.49265274555297,NA,NA,NA,NA,NA,NA,NA,NA
VIRGINIA,VA,HANOVER,51085,70988,25307,44318,69625,63.652423698384204,36.347576301615796,62753,19382,39630,59012,67.15583271199078,32.84416728800922,-5.216835041911471,10.666761567998728
VIRGINIA,VA,HARRISONBURG CITY,51660,17093,11022,5591,16613,33.654367061939446,66.34563293806056,NA,NA,NA,NA,NA,NA,NA,NA
VIRGINIA,VA,HENRICO,51087,183299,116572,63440,180012,35.24209497144635,64.75790502855365,163654,93935,59857,153792,38.92075010403662,61.07924989596338,-9.45165528094163,6.022757546721924
VIRGINIA,VA,HENRY,51089,26105,9127,16725,25852,64.69518799319202,35.304812006807985,24106,8198,15208,23406,64.97479278817397,35.02520721182603,-0.4303281056909247,0.798295905263191
VIRGINIA,VA,HIGHLAND,51091,1533,417,1092,1509,72.36580516898609,27.634194831013918,1391,371,958,1329,72.08427389014297,27.915726109857037,0.39055852774791955,-1.008504230680607
VIRGINIA,VA,HOPEWELL CITY,51670,9628,5430,4020,9450,42.53968253968254,57.46031746031746,NA,NA,NA,NA,NA,NA,NA,NA
VIRGINIA,VA,ISLE OF WIGHT,51093,23456,9399,13707,23106,59.322253960010386,40.677746039989614,21075,7881,12204,20085,60.76176250933533,39.23823749066467,-2.3691026887243116,3.668637128941943
VIRGINIA,VA,JAMES CITY,51095,49639,25553,23153,48706,47.53623783517431,52.46376216482569,43173,19105,21306,40411,52.72326841701517,47.27673158298483,-9.8382189450282,10.971635322835427
VIRGINIA,VA,KING AND QUEEN,51097,4115,1590,2450,4040,60.64356435643565,39.35643564356435,3697,1468,2099,3567,58.84496776002243,41.15503223997757,3.0565002665106977,-4.370295680794245
VIRGINIA,VA,KING GEORGE,51099,14227,5404,8446,13850,60.981949458483754,39.018050541516246,12059,4007,7341,11348,64.68981318293973,35.31018681706028,-5.731758281586485,10.500832928656422
VIRGINIA,VA,KING WILLIAM,51101,10737,3260,7320,10580,69.18714555765595,30.812854442344044,9161,2760,5975,8735,68.40297653119633,31.597023468803663,1.1463960579288335,-2.481781321059695
VIRGINIA,VA,LANCASTER,51103,7152,3368,3697,7065,52.32837933474876,47.67162066525124,6645,2869,3523,6392,55.11576971214018,44.88423028785982,-5.057337295567965,6.2101775156103045
VIRGINIA,VA,LEE,51105,9947,1489,8365,9854,84.88938502131114,15.110614978688858,9399,1627,7543,9170,82.25736095965104,17.742639040348966,3.1997428934672056,-14.83445645078254
VIRGINIA,VA,LEXINGTON CITY,51678,2764,1791,906,2697,33.59288097886541,66.40711902113459,NA,NA,NA,NA,NA,NA,NA,NA
VIRGINIA,VA,LOUDOUN,51107,224976,138372,82088,220460,37.23487253923614,62.76512746076386,183097,100795,69949,170744,40.96717893454528,59.03282106545472,-9.110479394425418,6.322425945341181
VIRGINIA,VA,LOUISA,51109,21916,8269,13294,21563,61.65190372397162,38.34809627602838,17631,6212,10528,16740,62.89127837514934,37.10872162485066,-1.9706622018156317,3.339847337526569
VIRGINIA,VA,LUNENBURG,51111,6002,2418,3537,5955,59.395465994962215,40.604534005037785,5586,2227,3204,5431,58.99466028355736,41.00533971644264,0.6793932018226423,-0.9774476060349202
VIRGINIA,VA,LYNCHBURG CITY,51680,36364,18048,17097,35145,48.64703371745625,51.35296628254375,NA,NA,NA,NA,NA,NA,NA,NA
VIRGINIA,VA,MADISON,51113,8133,2698,5300,7998,66.26656664166042,33.73343335833958,6979,2203,4419,6622,66.73210510419813,33.267894895801874,-0.697622923495067,1.39936255057862
VIRGINIA,VA,MANASSAS CITY,51683,16978,10356,6256,16612,37.65952323621478,62.34047676378522,NA,NA,NA,NA,NA,NA,NA,NA
VIRGINIA,VA,MANASSAS PARK CITY,51685,6088,3992,1979,5971,33.14352704739574,66.85647295260425,NA,NA,NA,NA,NA,NA,NA,NA
VIRGINIA,VA,MARTINSVILLE CITY,51690,6024,3766,2165,5931,36.50311920418142,63.49688079581858,NA,NA,NA,NA,NA,NA,NA,NA
VIRGINIA,VA,MATHEWS,51115,5829,1825,3901,5726,68.1278379322389,31.87216206776109,5311,1563,3517,5080,69.23228346456693,30.76771653543307,-1.5952753210765946,3.5896246348217087
VIRGINIA,VA,MECKLENBURG,51117,16207,6803,9266,16069,57.66382475574087,42.33617524425913,14945,6285,8288,14573,56.87229808550058,43.12770191449942,1.391761361656818,-1.8353091750853978
VIRGINIA,VA,MIDDLESEX,51119,6785,2491,4196,6687,62.74861671900703,37.25138328099297,6017,2108,3670,5778,63.516787815853235,36.483212184146765,-1.209398527950234,2.1055467730442867
VIRGINIA,VA,MONTGOMERY,51121,45037,23218,20629,43847,47.0476885533788,52.9523114466212,43031,20021,19459,39480,49.28824721377913,50.71175278622087,-4.5458274275453565,4.418223660786436
VIRGINIA,VA,NELSON,51125,9318,4327,4812,9139,52.65346317977897,47.34653682022103,8318,3689,4154,7843,52.96442687747036,47.03557312252964,-0.5871180262382203,0.6611245001338029
VIRGINIA,VA,NEW KENT,51127,14471,4621,9631,14252,67.57648049396576,32.42351950603424,12242,3546,8118,11664,69.59876543209876,30.401234567901234,-2.905633347916148,6.651982943706525
VIRGINIA,VA,NEWPORT NEWS CITY,51700,81270,53099,26377,79476,33.188635562937236,66.81136443706276,NA,NA,NA,NA,NA,NA,NA,NA
VIRGINIA,VA,NORFOLK CITY,51710,89988,64440,23443,87883,26.6752386695948,73.3247613304052,NA,NA,NA,NA,NA,NA,NA,NA
VIRGINIA,VA,NORTHAMPTON,51131,6732,3667,2955,6622,44.6239806704923,55.3760193295077,6172,3255,2686,5941,45.21124389833361,54.78875610166639,-1.298931808118109,1.0718681525669016
VIRGINIA,VA,NORTHUMBERLAND,51133,7815,3252,4485,7737,57.9682047305157,42.0317952694843,7398,2852,4302,7154,60.1341906625664,39.8658093374336,-3.6019208177337725,5.433191920719027
VIRGINIA,VA,NORTON CITY,51720,1601,464,1109,1573,70.50222504767959,29.497774952320405,NA,NA,NA,NA,NA,NA,NA,NA
VIRGINIA,VA,NOTTOWAY,51135,7078,2971,4027,6998,57.54501286081738,42.45498713918262,6744,2829,3712,6541,56.74973245681088,43.25026754318912,1.4013817679435547,-1.838787247298157
VIRGINIA,VA,ORANGE,51137,20754,7995,12426,20421,60.84912589980902,39.15087410019098,17270,5957,10521,16478,63.84876805437553,36.15123194562447,-4.698042336559927,8.29748252861291
VIRGINIA,VA,PAGE,51139,12514,3007,9345,12352,75.65576424870466,24.344235751295336,10740,2514,7831,10345,75.69840502658289,24.30159497341711,-0.056329823413403535,0.17546493522284656
VIRGINIA,VA,PATRICK,51141,9535,1954,7485,9439,79.29865451848713,20.70134548151287,8525,1768,6454,8222,78.4967161274629,21.503283872537096,1.0216203053921902,-3.729376386312888
VIRGINIA,VA,PETERSBURG CITY,51730,14133,12389,1584,13973,11.336148285980105,88.6638517140199,NA,NA,NA,NA,NA,NA,NA,NA
VIRGINIA,VA,PITTSYLVANIA,51143,34227,10115,23751,33866,70.1322860686234,29.867713931376603,31598,9199,21554,30753,70.0874711410269,29.912528858973108,0.06394142471817243,-0.14981992264108124
VIRGINIA,VA,POQUOSON CITY,51735,7857,2054,5605,7659,73.18187752970361,26.818122470296384,NA,NA,NA,NA,NA,NA,NA,NA
VIRGINIA,VA,PORTSMOUTH CITY,51740,44601,30948,12755,43703,29.18563942978743,70.81436057021257,NA,NA,NA,NA,NA,NA,NA,NA
VIRGINIA,VA,POWHATAN,51145,19733,5320,14055,19375,72.54193548387097,27.45806451612903,16900,4060,11885,15945,74.53747256193164,25.46252743806836,-2.6772266478483187,7.837152391546165
VIRGINIA,VA,PRINCE EDWARD,51147,9575,4973,4434,9407,47.135112150526204,52.864887849473796,9143,4591,4101,8692,47.18131615278417,52.81868384721583,-0.09792859976255341,0.08747662549035695
VIRGINIA,VA,PRINCE GEORGE,51149,17439,7103,10103,17206,58.71788910845054,41.28211089154946,16184,6419,9157,15576,58.78916281458655,41.21083718541345,-0.12123613047662074,0.17294894014245887
VIRGINIA,VA,PRINCE WILLIAM,51153,228267,142863,81222,224085,36.24606734051811,63.75393265948189,196538,113144,71721,184865,38.796419008465634,61.203580991534366,-6.573678017527906,4.166997464250155
VIRGINIA,VA,PULASKI,51155,17386,4925,12127,17052,71.11775744780671,28.88224255219329,15167,4172,10322,14494,71.21567545191114,28.784324548088865,-0.13749501564518374,0.3401782242304696
VIRGINIA,VA,RADFORD CITY,51750,6320,3358,2786,6144,45.345052083333336,54.654947916666664,NA,NA,NA,NA,NA,NA,NA,NA
VIRGINIA,VA,RAPPAHANNOCK,51157,4979,2096,2812,4908,57.29421352893235,42.70578647106765,4483,1747,2539,4286,59.23938404106393,40.76061595893607,-3.283576532097654,4.772181348022864
VIRGINIA,VA,RICHMOND,51159,4102,1513,2547,4060,62.73399014778325,37.26600985221675,3661,1347,2213,3560,62.162921348314605,37.837078651685395,0.9186646751506489,-1.5092835383135772
VIRGINIA,VA,RICHMOND,51159,4102,1513,2547,4060,62.73399014778325,37.26600985221675,103484,81259,15581,96840,16.08942585708385,83.91057414291615,289.9081962589905,-55.588422278287084
VIRGINIA,VA,RICHMOND CITY,51760,111181,92175,16603,108778,15.263196602254132,84.73680339774587,NA,NA,NA,NA,NA,NA,NA,NA
VIRGINIA,VA,ROANOKE,51161,57226,21801,34268,56069,61.11755158822166,38.88244841177834,51489,17200,31408,48608,64.61487820934826,35.385121790651745,-5.412571714204084,9.883607697658237
VIRGINIA,VA,ROANOKE,51161,57226,21801,34268,56069,61.11755158822166,38.88244841177834,39466,22286,14789,37075,39.8894133513149,60.1105866486851,53.217474145196974,-35.315140677255584
VIRGINIA,VA,ROANOKE CITY,51770,43323,26773,15607,42380,36.82633317602643,63.17366682397357,NA,NA,NA,NA,NA,NA,NA,NA
VIRGINIA,VA,ROCKBRIDGE,51163,12377,4086,8088,12174,66.43666830951207,33.56333169048793,10795,3508,6680,10188,65.56733411857087,34.43266588142913,1.3258647810342694,-2.5247368122317537
VIRGINIA,VA,ROCKINGHAM,51165,43821,12644,30349,42993,70.59056125415765,29.409438745842348,37487,9366,25990,35356,73.5094467699966,26.490553230003393,-3.9707624585610612,11.018590251761907
VIRGINIA,VA,RUSSELL,51167,13386,2373,10879,13252,82.09326894053727,17.90673105946272,12246,2330,9521,11851,80.33921188085394,19.660788119146062,2.183313750058513,-8.921600950346464
VIRGINIA,VA,SALEM CITY,51775,13051,5148,7683,12831,59.878419452887535,40.121580547112465,NA,NA,NA,NA,NA,NA,NA,NA
VIRGINIA,VA,SCOTT,51169,10869,1692,9063,10755,84.26778242677824,15.732217573221757,10100,1581,8247,9828,83.91330891330891,16.086691086691086,0.42242823940543683,-2.2035203607694953
VIRGINIA,VA,SHENANDOAH,51171,23684,6836,16463,23299,70.65968496501996,29.34031503498004,20513,5273,14094,19367,72.77327412609077,27.226725873909228,-2.9043480404752575,7.762920781805116
VIRGINIA,VA,SMYTH,51173,14136,3008,10963,13971,78.4696872092191,21.530312790780904,12890,2665,9750,12415,78.53403141361257,21.465968586387433,-0.08193162026101097,0.2997498302232504
VIRGINIA,VA,SOUTHAMPTON,51175,9786,3969,5730,9699,59.07825549025673,40.92174450974327,8878,3595,5035,8630,58.34298957126303,41.65701042873697,1.2602472454648739,-1.7650472547748541
VIRGINIA,VA,SPOTSYLVANIA,51177,75317,34307,39411,73718,53.4618410700236,46.5381589299764,62562,24207,34623,58830,58.85262621111678,41.14737378888322,-9.159803883271566,13.101164533007449
VIRGINIA,VA,STAFFORD,51179,79629,40245,37636,77881,48.32500866706899,51.67499133293101,65934,27908,33868,61776,54.82387982387982,45.17612017612018,-11.854088360196812,14.385633674327991
VIRGINIA,VA,STAUNTON CITY,51790,12992,6981,5695,12676,44.927421899652884,55.072578100347116,NA,NA,NA,NA,NA,NA,NA,NA
VIRGINIA,VA,SUFFOLK CITY,51800,49642,28676,20082,48758,41.187087247220965,58.812912752779035,NA,NA,NA,NA,NA,NA,NA,NA
VIRGINIA,VA,SURRY,51181,4471,2397,2025,4422,45.79375848032564,54.20624151967436,4228,2272,1819,4091,44.463456367636276,55.536543632363724,2.9918999136955504,-2.395363531255368
VIRGINIA,VA,SUSSEX,51183,5088,2827,2219,5046,43.975426080063414,56.024573919936586,5044,2879,2055,4934,41.64977705715444,58.35022294284556,5.583821060356642,-3.985672899976689
VIRGINIA,VA,TAZEWELL,51185,20152,3205,16731,19936,83.92355537720707,16.076444622792938,18566,2895,15168,18063,83.97276199966782,16.027238000332172,-0.05859831365431223,0.30701872936400587
VIRGINIA,VA,VIRGINIA BEACH CITY,51810,227717,117393,105087,222480,47.23435814455232,52.76564185544768,NA,NA,NA,NA,NA,NA,NA,NA
VIRGINIA,VA,WARREN,51187,21147,6603,14069,20672,68.05824303405572,31.941756965944272,17960,5169,11773,16942,69.49002479046158,30.509975209538425,-2.0604133625267917,4.692831595478397
VIRGINIA,VA,WASHINGTON,51191,28693,6617,21679,28296,76.61506926774102,23.384930732258976,25847,5553,19320,24873,77.67458690145942,22.325413098540587,-1.3640466927265948,4.74579184287367
VIRGINIA,VA,WAYNESBORO CITY,51820,10717,4961,5507,10468,52.60794803209782,47.39205196790218,NA,NA,NA,NA,NA,NA,NA,NA
VIRGINIA,VA,WESTMORELAND,51193,9948,4501,5318,9819,54.160301456360116,45.839698543639884,8574,3836,4448,8284,53.69386769676485,46.30613230323515,0.8686909317642044,-1.0072829156640317
VIRGINIA,VA,WILLIAMSBURG CITY,51830,6890,4790,1963,6753,29.06856212053902,70.93143787946099,NA,NA,NA,NA,NA,NA,NA,NA
VIRGINIA,VA,WINCHESTER CITY,51840,12113,6610,5221,11831,44.129828416870936,55.870171583129064,NA,NA,NA,NA,NA,NA,NA,NA
VIRGINIA,VA,WISE,51195,16615,3110,13366,16476,81.12405923767905,18.87594076232095,15163,2701,12086,14787,81.73395550145398,18.26604449854602,-0.7461969263974688,3.3389618853905567
VIRGINIA,VA,WYTHE,51197,15073,3143,11733,14876,78.87200860446356,21.127991395536434,13343,2770,10046,12816,78.38639200998752,21.613607990012483,0.6195164518022045,-2.2468094854891874
VIRGINIA,VA,YORK,51199,38791,17683,20241,37924,53.37253454276975,46.62746545723025,34118,12999,18837,31836,59.1688654353562,40.8311345646438,-9.79625154198558,14.195860473604306
WASHINGTON,WA,ADAMS,53001,5862,1814,3907,5721,68.29225659849676,31.707743401503233,4644,1299,3083,4382,70.35600182565038,29.643998174349612,-2.933289518451887,6.961764115001667
WASHINGTON,WA,ASOTIN,53003,11951,4250,7319,11569,63.263894891520444,36.736105108479556,9736,3134,5741,8875,64.68732394366197,35.31267605633803,-2.200476021208153,4.030929431319752
WASHINGTON,WA,BENTON,53005,103033,38706,60365,99071,60.93104944938479,39.06895055061521,80027,26360,47194,73554,64.16238409875737,35.83761590124262,-5.036182328261029,9.016600485582394
WASHINGTON,WA,CHELAN,53007,43306,19349,22746,42095,54.03492101199667,45.96507898800333,33380,13032,18114,31146,58.15835099210172,41.84164900789828,-7.090004977384989,9.854845776577026
WASHINGTON,WA,CLALLAM,53009,49264,24721,23062,47783,48.264026955193266,51.735973044806734,39457,17677,18794,36471,51.53135367826492,48.46864632173508,-6.3404636009974595,6.741114041814011
WASHINGTON,WA,CLARK,53011,275403,140324,126303,266627,47.37067138736887,52.62932861263113,200160,92757,92441,185198,49.91468590373546,50.08531409626454,-5.09672548330351,5.0793622088042945
WASHINGTON,WA,COLUMBIA,53013,2495,668,1754,2422,72.41948802642445,27.580511973575558,2182,526,1497,2023,73.99901136925358,26.000988630746416,-2.1345195207370327,6.074858788105231
WASHINGTON,WA,COWLITZ,53015,60280,23938,34424,58362,58.983585209554164,41.016414790445836,45692,17908,24185,42093,57.45610909177298,42.54389090822702,2.6585094986877555,-3.590353597596796
WASHINGTON,WA,DOUGLAS,53017,21308,7811,12955,20766,62.38563035731484,37.61436964268516,15543,4918,9603,14521,66.13180910405619,33.868190895943805,-5.664715357849747,11.061053595248316
WASHINGTON,WA,FERRY,53019,4367,1486,2771,4257,65.0927883486023,34.907211651397695,3601,1098,2202,3300,66.72727272727273,33.27272727272727,-2.449499750051065,4.912384744637888
WASHINGTON,WA,FRANKLIN,53021,32404,13340,18039,31379,57.48749163453265,42.51250836546735,23720,8886,13206,22092,59.77729494839761,40.22270505160239,-3.8305569294187936,5.692812830284111
WASHINGTON,WA,GARFIELD,53023,1489,366,1069,1435,74.49477351916376,25.505226480836235,1246,279,851,1130,75.30973451327434,24.690265486725664,-1.082145620851882,3.300738076505172
WASHINGTON,WA,GRANT,53025,37680,11819,24764,36583,67.69264412432004,32.30735587567996,28346,7810,18518,26328,70.3357642054087,29.66423579459131,-3.7578607568259037,8.910123622906774
WASHINGTON,WA,GRAYS HARBOR,53027,38441,17354,19877,37231,53.38830544438774,46.61169455561226,28367,12020,14067,26087,53.92341012764979,46.07658987235021,-0.9923420681209216,1.161337426976461
WASHINGTON,WA,ISLAND,53029,53925,29213,22746,51959,43.776824034334766,56.223175965665234,42876,20960,18465,39425,46.83576410906785,53.16423589093215,-6.531205656450146,5.753755364806867
WASHINGTON,WA,JEFFERSON,53031,24792,17204,6931,24135,28.71762999792832,71.28237000207169,20276,12656,6037,18693,32.29551168886749,67.70448831113251,-11.07857254409904,5.284556135329188
WASHINGTON,WA,KING,53033,1210507,907310,269167,1176477,22.879070309066815,77.12092969093318,998499,718322,216339,934661,23.14625302649838,76.85374697350163,-1.15432384293771,0.34765086668275824
WASHINGTON,WA,KITSAP,53035,158672,90277,61563,151840,40.54465226554267,59.45534773445733,124317,63156,49018,112174,43.69818317970296,56.30181682029704,-7.216617911073808,5.601117498971053
WASHINGTON,WA,KITTITAS,53037,26364,11421,14105,25526,55.25738462743869,44.74261537256131,18955,7489,10100,17589,57.422252544203765,42.577747455796235,-3.7700853255426603,5.084505513150073
WASHINGTON,WA,KLICKITAT,53039,13560,5959,7237,13196,54.84237647772052,45.15762352227948,10769,4194,5789,9983,57.9885805869979,42.0114194130021,-5.425558062345148,7.488925994972839
WASHINGTON,WA,LEWIS,53041,45309,14520,29391,43911,66.93311470929835,33.06688529070165,34149,9654,21992,31646,69.49377488466156,30.50622511533843,-3.684733171587129,8.393893920607454
WASHINGTON,WA,LINCOLN,53043,7033,1713,5150,6863,75.04006994025936,24.95993005974064,5713,1244,4108,5352,76.75635276532138,23.243647234678626,-2.2360140408305584,7.383879163771612
WASHINGTON,WA,MASON,53045,37303,17269,18710,35979,52.002557047166405,47.997442952833595,28073,11993,13677,25670,53.280093494351384,46.719906505648616,-2.397774409537057,2.734458484052227
WASHINGTON,WA,OKANOGAN,53047,21282,8900,11840,20740,57.087753134040504,42.912246865959496,17091,6298,9610,15908,60.409856675886346,39.590143324113654,-5.4992740003833145,8.391238987564886
WASHINGTON,WA,PACIFIC,53049,14064,6794,6953,13747,50.57830799447152,49.42169200552848,10716,4620,5360,9980,53.70741482965932,46.29258517034068,-5.826210114771313,6.759412600687065
WASHINGTON,WA,PEND OREILLE,53051,8553,2593,5728,8321,68.83788006249249,31.162119937507512,6802,1934,4373,6307,69.33565879181862,30.664341208181387,-0.717926010944403,1.6233146048913571
WASHINGTON,WA,PIERCE,53053,464081,249506,197730,447236,44.21155720916921,55.78844279083079,348485,172538,146824,319362,45.97416098346078,54.02583901653922,-3.8339009056101436,3.2625199467091637
WASHINGTON,WA,SAN JUAN,53055,13197,9725,3057,12782,23.91644500078235,76.08355499921765,10774,7172,2688,9860,27.261663286004058,72.73833671399595,-12.270778382546887,4.598975500876468
WASHINGTON,WA,SKAGIT,53057,73423,38252,32762,71014,46.13456501534909,53.86543498465091,55968,26690,24736,51426,48.100182786917124,51.899817213082876,-4.086507904295667,3.787330817559309
WASHINGTON,WA,SKAMANIA,53059,7312,3192,3885,7077,54.896142433234424,45.103857566765576,5639,2232,2928,5160,56.74418604651163,43.25581395348837,-3.2567981709393345,4.272358890909667
WASHINGTON,WA,SNOHOMISH,53061,438796,256728,166428,423156,39.33017610526614,60.66982389473386,342173,185227,128255,313482,40.913034879195614,59.086965120804386,-3.8688373487892003,2.6788628772747014
WASHINGTON,WA,SPOKANE,53063,295430,135765,148576,284341,52.25275285660528,47.74724714339472,227246,93767,113435,207202,54.74609318442872,45.25390681557128,-4.554371248782774,5.50966867454088
WASHINGTON,WA,STEVENS,53065,28430,7839,19808,27647,71.64610988534018,28.35389011465982,22677,5767,15161,20928,72.44361620795107,27.55638379204893,-1.1008648716839708,2.894089183214965
WASHINGTON,WA,THURSTON,53067,168134,96608,65277,161885,40.32306884516787,59.67693115483213,129410,68798,48624,117422,41.4096165965492,58.5903834034508,-2.623901983849508,1.8544813811840255
WASHINGTON,WA,WAHKIAKUM,53069,2981,1165,1741,2906,59.910529938059184,40.089470061940816,2358,832,1344,2176,61.76470588235294,38.23529411764706,-3.0019991479041774,4.849383238922145
WASHINGTON,WA,WALLA WALLA,53071,31261,13690,16400,30090,54.50315719508142,45.49684280491858,25419,9694,13651,23345,58.47504819019062,41.52495180980938,-6.792454419516824,9.565070691234201
WASHINGTON,WA,WHATCOM,53073,138620,83660,50489,134149,37.636508658282956,62.363491341717044,109673,60340,40599,100939,40.22132178840686,59.77867821159314,-6.426474852621411,4.323971702710927
WASHINGTON,WA,WHITMAN,53075,21126,11184,9067,20251,44.77309762480865,55.22690237519135,17305,8146,7403,15549,47.61077882822046,52.38922117177954,-5.96016547775905,5.416536340762379
WASHINGTON,WA,YAKIMA,53077,96193,43179,50555,93734,53.93453816117951,46.06546183882049,77750,31291,41735,73026,57.150877769561525,42.849122230438475,-5.627804390600333,7.506197189022568
WEST VIRGINIA,WV,BARBOUR,54001,6677,1457,5116,6573,77.83356153963183,22.166438460368173,6054,1222,4527,5749,78.7441294138111,21.2558705861889,-1.1563628691532157,4.283841823777923
WEST VIRGINIA,WV,BERKELEY,54003,51535,17186,33279,50465,65.94471415832756,34.05528584167244,42850,12321,28244,40565,69.62652532971774,30.373474670282263,-5.287943285917107,12.121797757279662
WEST VIRGINIA,WV,BOONE,54005,9012,2041,6816,8857,76.95607993677318,23.043920063226825,8683,1790,6504,8294,78.41813359054738,21.581866409452616,-1.8644331187581908,6.774454192404078
WEST VIRGINIA,WV,BRAXTON,54007,5664,1457,4120,5577,73.87484310561234,26.125156894387665,5090,1321,3537,4858,72.80773981062165,27.192260189378345,1.465645407708438,-3.9242905428196195
WEST VIRGINIA,WV,BROOKE,54009,10656,2947,7545,10492,71.9119329012581,28.0880670987419,9613,2568,6625,9193,72.06570216469052,27.934297835309476,-0.21337371150705886,0.550467616329553
WEST VIRGINIA,WV,CABELL,54011,37360,14994,21721,36715,59.161105815061966,40.838894184938034,33085,11447,19850,31297,63.424609387481226,36.575390612518774,-6.722159763526725,11.6567547222858
WEST VIRGINIA,WV,CALHOUN,54013,2971,568,2364,2932,80.6275579809004,19.37244201909959,2617,456,2035,2491,81.69409875551987,18.30590124448013,-1.3055297639199548,5.826212871879566
WEST VIRGINIA,WV,CLAY,54015,3365,641,2679,3320,80.69277108433735,19.30722891566265,2972,568,2300,2868,80.1952580195258,19.804741980474198,0.6203771608171982,-2.512090615985063
WEST VIRGINIA,WV,DODDRIDGE,54017,3101,435,2619,3054,85.75638506876228,14.24361493123772,2840,362,2358,2720,86.69117647058823,13.308823529411764,-1.0783005144048285,7.023846997145311
WEST VIRGINIA,WV,FAYETTE,54019,16862,5063,11580,16643,69.57880189869614,30.42119810130385,15337,4290,10357,14647,70.71072574588653,29.28927425411347,-1.6007809780629212,3.8646360349178455
WEST VIRGINIA,WV,GILMER,54021,2662,599,2012,2611,77.0585982382229,22.941401761777097,2543,545,1896,2441,77.67308480131094,22.32691519868906,-0.7911190403469881,2.7522233036658683
WEST VIRGINIA,WV,GRANT,54023,5509,607,4871,5478,88.9193136181088,11.080686381891201,4956,512,4346,4858,89.46068340881021,10.53931659118979,-0.6051482842216904,5.136668834428626
WEST VIRGINIA,WV,GREENBRIER,54025,15850,4655,10925,15580,70.1219512195122,29.878048780487806,14066,3765,9556,13321,71.73635612941972,28.263643870580285,-2.250469632155516,5.711948952158852
WEST VIRGINIA,WV,HAMPSHIRE,54027,10086,1939,8033,9972,80.55555555555556,19.444444444444443,8608,1580,6692,8272,80.89941972920697,19.100580270793035,-0.42505147107657626,1.8002812939521773
WEST VIRGINIA,WV,HANCOCK,54029,13800,3790,9806,13596,72.12415416298911,27.875845837010885,12702,3262,8909,12171,73.1985868046997,26.801413195300302,-1.4678324932382525,4.008865629141489
WEST VIRGINIA,WV,HARDY,54031,6331,1381,4859,6240,77.86858974358974,22.131410256410255,5643,1155,4274,5429,78.72536378706944,21.27463621293056,-1.0883075063292669,4.02720890220889
WEST VIRGINIA,WV,HARRISON,54033,30465,9215,20683,29898,69.17854037059335,30.82145962940665,27960,7694,18750,26444,70.90455301769778,29.095446982302224,-2.4342761834682314,5.932243103721002
WEST VIRGINIA,WV,JACKSON,54035,13508,3207,10093,13300,75.88721804511279,24.112781954887218,12187,2663,9020,11683,77.20619703843191,22.79380296156809,-1.7083848757147746,5.786568373618994
WEST VIRGINIA,WV,JEFFERSON,54037,27703,12127,15033,27160,55.34977908689249,44.65022091310751,24147,9518,13204,22722,58.11108177097086,41.88891822902914,-4.751766100244536,6.59196465514067
WEST VIRGINIA,WV,KANAWHA,54039,82244,34344,46398,80742,57.46451660845656,42.53548339154344,75690,28263,43850,72113,60.807344029509245,39.192655970490755,-5.4974073845922895,8.52921890154521
WEST VIRGINIA,WV,LEWIS,54041,7457,1538,5782,7320,78.98907103825137,21.010928961748633,6928,1347,5274,6621,79.65564114182148,20.344358858178524,-0.8368146863363068,3.2764370124259035
WEST VIRGINIA,WV,LINCOLN,54043,7830,1711,6012,7723,77.84539686650265,22.154603133497346,7066,1459,5307,6766,78.43629914277268,21.563700857227314,-0.7533530810708511,2.7402637431412247
WEST VIRGINIA,WV,LOGAN,54045,13026,2333,10534,12867,81.86834537965338,18.131654620346623,12359,2092,9897,11989,82.5506714488281,17.449328551171906,-0.8265542329327857,3.9103285101987018
WEST VIRGINIA,WV,MARION,54049,25794,8901,16300,25201,64.67997301694378,35.32002698305623,23029,6964,14668,21632,67.8069526627219,32.19304733727811,-4.611591471057563,9.713214201245313
WEST VIRGINIA,WV,MARSHALL,54051,14080,3455,10435,13890,75.12598992080633,24.874010079193663,13216,2918,9666,12584,76.81182453909727,23.188175460902734,-2.1947592423518736,7.270234008421195
WEST VIRGINIA,WV,MASON,54053,11203,2526,8491,11017,77.07179813016248,22.928201869837523,10186,2081,7654,9735,78.62352336928608,21.37647663071392,-1.9736144764656682,7.259031813007333
WEST VIRGINIA,WV,MCDOWELL,54047,6527,1333,5148,6481,79.43218639098905,20.567813609010955,6203,1438,4629,6067,76.29800560408769,23.701994395912312,4.107814826988654,-13.22327874417979
WEST VIRGINIA,WV,MERCER,54055,25134,5556,19237,24793,77.59044891703303,22.409551082966967,22982,4704,17404,22108,78.72263434051023,21.277365659489778,-1.438195549427368,5.321078941801383
WEST VIRGINIA,WV,MINERAL,54057,12872,2660,10040,12700,79.05511811023622,20.944881889763778,11564,2050,9070,11120,81.56474820143885,18.43525179856115,-3.076856297042252,13.613212982523514
WEST VIRGINIA,WV,MINGO,54059,10022,1397,8544,9941,85.94708781812695,14.052912181873051,9510,1370,7911,9281,85.23865962719535,14.761340372804655,0.8311113689844829,-4.799213167909655
WEST VIRGINIA,WV,MONONGALIA,54061,42072,20282,20803,41085,50.634051356942926,49.365948643057074,36048,14699,18432,33131,55.63369653798557,44.36630346201443,-8.986721163906463,11.269014524329801
WEST VIRGINIA,WV,MONROE,54063,6490,1345,5068,6413,79.02697645407765,20.973023545922345,5805,1111,4443,5554,79.99639899171768,20.00360100828232,-1.2118327197957912,4.846240120659484
WEST VIRGINIA,WV,MORGAN,54065,8695,1998,6537,8535,76.59050966608085,23.409490333919155,7654,1573,5732,7305,78.46680355920603,21.533196440793976,-2.391194502665639,8.713494525924625
WEST VIRGINIA,WV,NICHOLAS,54067,10630,2226,8279,10505,78.81009043312709,21.189909566872917,9491,1840,7251,9091,79.76020239797602,20.23979760202398,-1.191210574050694,4.694276017631349
WEST VIRGINIA,WV,OHIO,54069,19898,7223,12354,19577,63.10466363589927,36.89533636410073,17938,5493,11139,16632,66.97330447330447,33.026695526695526,-5.776392351891846,11.713678210035194
WEST VIRGINIA,WV,PENDLETON,54071,3659,820,2782,3602,77.234869516935035,22.765130483064965,3225,729,2398,3127,76.68692037096258,23.313079629037418,0.7145275143685792,-2.350393661805017
WEST VIRGINIA,WV,PLEASANTS,54073,3491,699,2742,3441,79.68613775065388,20.31386224934612,3150,621,2358,2979,79.15407854984895,20.845921450151057,0.6721816620856247,-2.552341963281657
WEST VIRGINIA,WV,POCAHONTAS,54075,4008,1047,2895,3942,73.43987823439878,26.560121765601217,3646,928,2496,3424,72.89719626168224,27.102803738317757,0.7444483471880758,-2.002309347609299
WEST VIRGINIA,WV,PRESTON,54077,14572,3163,11190,14353,77.96279523444576,22.03720476555424,12659,2470,9538,12008,79.43037974683544,20.569620253164558,-1.8476362785463718,7.134718552540598
WEST VIRGINIA,WV,PUTNAM,54079,28501,7878,20034,27912,71.7755803955288,28.224419604471194,24893,5884,17788,23672,75.14362960459614,24.856370395403854,-4.482148688837528,13.550044336682877
WEST VIRGINIA,WV,RALEIGH,54081,33106,7982,24673,32655,75.55657632828051,24.44342367171949,29618,6443,22048,28491,77.38584114281703,22.61415885718297,-2.3638236498076837,8.089024341294415
WEST VIRGINIA,WV,RANDOLPH,54083,12200,3362,8673,12035,72.06481096800997,27.935189031990028,10876,2735,7629,10364,73.61057506754149,26.38942493245851,-2.099921238372615,5.857513392155256
WEST VIRGINIA,WV,RITCHIE,54085,4283,586,3649,4235,86.1629279811098,13.8370720188902,4075,496,3405,3901,87.28531145860036,12.71468854139964,-1.2858789855185515,8.827455535666683
WEST VIRGINIA,WV,ROANE,54087,5763,1455,4213,5668,74.32956951305574,25.670430486944248,5247,1222,3781,5003,75.57465520687587,24.425344793124125,-1.6474910674906362,5.097515324207924
WEST VIRGINIA,WV,SUMMERS,54089,5585,1448,4074,5522,73.77761680550525,26.22238319449475,4862,1190,3455,4645,74.3810548977395,25.618945102260493,-0.8112792875334618,2.355436923048848
WEST VIRGINIA,WV,TAYLOR,54091,7383,1796,5477,7273,75.30592602777396,24.694073972226043,6538,1491,4733,6224,76.04434447300771,23.955655526992288,-0.9710366370451862,3.0824389021696152
WEST VIRGINIA,WV,TUCKER,54093,3844,938,2841,3779,75.17861868219106,24.821381317808942,3475,751,2565,3316,77.35223160434258,22.64776839565742,-2.8100196685592382,9.597470638953997
WEST VIRGINIA,WV,TYLER,54095,3922,631,3226,3857,83.64013481980814,16.35986518019186,3654,507,2996,3503,85.52669140736512,14.473308592634885,-2.205810322500701,13.03472924302187
WEST VIRGINIA,WV,UPSHUR,54097,10221,2256,7771,10027,77.50074798045277,22.49925201954722,9218,1766,7005,8771,79.86546573936837,20.13453426063163,-2.9608764401782617,11.744586332643635
WEST VIRGINIA,WV,WAYNE,54099,16947,4088,12585,16673,75.48131709950219,24.51868290049781,15182,3357,11152,14509,76.862636983941,23.137363016059,-1.7971278876724117,5.970083468371379
WEST VIRGINIA,WV,WEBSTER,54101,3402,610,2759,3369,81.89373701395073,18.106262986049273,2978,556,2302,2858,80.54583624912526,19.454163750874738,1.6734580303523927,-6.928597816315063
WEST VIRGINIA,WV,WETZEL,54103,6667,1539,4993,6532,76.43906919779546,23.56093080220453,6265,1359,4519,5878,76.87989111942838,23.120108880571625,-0.5733904083554564,1.9066602320516823
WEST VIRGINIA,WV,WIRT,54105,2653,466,2134,2600,82.07692307692308,17.923076923076923,2422,386,1911,2297,83.19547235524597,16.804527644754028,-1.344483355472359,6.656237544838572
WEST VIRGINIA,WV,WOOD,54107,38762,10926,27202,38128,71.34389425094419,28.65610574905581,35615,8400,25434,33834,75.17290299698529,24.827097003014718,-5.093602339921144,15.422700227804098
WEST VIRGINIA,WV,WYOMING,54109,8592,1157,7353,8510,86.4042303172738,13.595769682726205,7831,1062,6547,7609,86.04284400052569,13.957155999474306,0.4200074055500824,-2.589254693160359
WISCONSIN,WI,ADAMS,55001,11818,4329,7362,11691,62.971516551193226,37.028483448806774,10164,3770,5983,9753,61.3452271096073,38.6547728903927,2.6510447808436366,-4.207215099147888
WISCONSIN,WI,ASHLAND,55003,8757,4801,3841,8642,44.4457301550567,55.5542698449433,8029,4228,3302,7530,43.85126162018592,56.14873837981408,1.3556475068373652,-1.0587388996161184
WISCONSIN,WI,BARRON,55005,25346,9194,15803,24997,63.21958635036204,36.78041364963796,22643,7879,13606,21485,63.32790318827089,36.67209681172911,-0.17104125110036783,0.295365815772497
WISCONSIN,WI,BAYFIELD,55007,10880,6147,4617,10764,42.89297658862876,57.10702341137124,9529,4954,4125,9079,45.43451922017844,54.56548077982156,-5.593858315597455,4.65778472988283
WISCONSIN,WI,BROWN,55009,144017,65511,75871,141382,53.66383273684062,46.33616726315938,128979,53364,67199,120563,55.737664125809744,44.262335874190256,-3.720700215007433,4.6853184496717715
WISCONSIN,WI,BUFFALO,55011,7816,2860,4834,7694,62.82817780088381,37.17182219911619,6988,2531,4049,6580,61.53495440729483,38.46504559270517,2.101607787062343,-3.3620742512111668
WISCONSIN,WI,BURNETT,55013,10141,3569,6462,10031,64.42029707905493,35.57970292094507,8743,2948,5412,8360,64.73684210526316,35.26315789473684,-0.48897199170376826,0.8976649996949693
WISCONSIN,WI,CALUMET,55015,30774,12116,18156,30272,59.97621564482029,40.02378435517971,26650,9646,15348,24994,61.406737617028085,38.593262382971915,-2.3295847128851688,3.7066624687291716
WISCONSIN,WI,CHIPPEWA,55017,35938,13983,21317,35300,60.388101983002834,39.611898016997166,31561,11886,17909,29795,60.10740057056553,39.89259942943447,0.4669997533960357,-0.7036428221074753
WISCONSIN,WI,CLARK,55019,14898,4524,10002,14526,68.85584469227592,31.14415530772408,13596,4227,8646,12873,67.16383127476112,32.83616872523887,2.519233023787648,-5.1528953687409285
WISCONSIN,WI,COLUMBIA,55021,33869,16410,16927,33337,50.77541470438252,49.22458529561748,29771,13526,14160,27686,51.144983023911,48.855016976089,-0.7225895829424789,0.7564593001970765
WISCONSIN,WI,CRAWFORD,55023,8695,3953,4620,8573,53.89012014464015,46.10987985535985,7744,3425,3844,7269,52.88210207731462,47.11789792268538,1.9061611163863956,-2.139352797485916
WISCONSIN,WI,DANE,55025,344791,260185,78800,338985,23.245866336268566,76.75413366373144,310017,217526,71279,288805,24.680666885961116,75.31933311403888,-5.81345940254433,1.9049565236061827
WISCONSIN,WI,DODGE,55027,48436,16356,31355,47711,65.71859738844292,34.281402611557084,43065,13968,26643,40611,65.60537785329097,34.39462214670902,0.1725766070658441,-0.32917801704289706
WISCONSIN,WI,DOOR,55029,20117,10044,9752,19796,49.26247726813498,50.73752273186502,17608,8026,8584,16610,51.67971101745936,48.32028898254064,-4.677336041038904,5.002523371078738
WISCONSIN,WI,DOUGLAS,55031,24677,13218,10923,24141,45.24667577979371,54.75332422020629,22511,11345,9659,21004,45.98647876594934,54.01352123405066,-1.6087402341042445,1.3696625756908665
WISCONSIN,WI,DUNN,55033,23524,9897,13173,23070,57.1001300390117,42.8998699609883,22091,9026,11488,20514,56.00077995515258,43.99922004484742,1.9630978081725203,-2.49856720809728
WISCONSIN,WI,EAU CLAIRE,55035,58275,31620,25341,56961,44.488334123347556,55.511665876652444,54885,27294,23311,50605,46.064618120739055,53.935381879260945,-3.4218974599114937,2.922541646075949
WISCONSIN,WI,FLORENCE,55037,2940,781,2133,2914,73.198352779684285,26.80164722031572,2657,666,1897,2563,74.0148263753414,25.985173624658604,-1.103121679319552,3.1420748133170973
WISCONSIN,WI,FOND DU LAC,55039,57251,20588,35754,56342,63.45887614923148,36.54112385076852,51327,17391,31044,48435,64.09414679467328,35.90585320532673,-0.991152355108027,1.7692676506223526
WISCONSIN,WI,FOREST,55041,5053,1721,3285,5006,65.62125449460648,34.378745505393525,4540,1584,2788,4372,63.769441903019214,36.230558096980786,2.903918454239429,-5.111189804557769
WISCONSIN,WI,GRANT,55043,25608,10998,14142,25140,56.252983293556085,43.747016706443915,24321,10046,12349,22395,55.14177271712436,44.85822728287564,2.0151883439297524,-2.477161144653439
WISCONSIN,WI,GREEN,55045,21406,10851,10169,21020,48.37773549000951,51.62226450999049,18985,9122,8693,17815,48.79595846197025,51.20404153802975,-0.8570852692373787,0.8167772687437624
WISCONSIN,WI,GREEN LAKE,55047,10671,3344,7168,10512,68.18873668188736,31.811263318112633,9388,2701,6213,8914,69.69934933811982,30.300650661880187,-2.167326769299227,4.985413260887084
WISCONSIN,WI,IOWA,55049,13992,7828,5909,13737,43.015214384508994,56.984785615491006,12260,6669,4809,11478,41.897543125980135,58.102456874019865,2.6676295914731307,-1.9236213383407197
WISCONSIN,WI,IRON,55051,4010,1533,2438,3971,61.39511458071015,38.60488541928985,3497,1273,2090,3363,62.14689265536723,37.85310734463277,-1.2096792655845734,1.986040585288107
WISCONSIN,WI,JACKSON,55053,10184,4256,5791,10047,57.63909624763611,42.36090375236389,9272,3821,4907,8728,56.22135655362053,43.77864344637947,2.5217102199649455,-3.238427649664477
WISCONSIN,WI,JEFFERSON,55055,47979,19904,27208,47112,57.751740533197484,42.248259466802516,43146,16561,23410,39971,58.567461409521904,41.432538590478096,-1.392788515487542,1.968792895813265
WISCONSIN,WI,JUNEAU,55057,13709,4746,8749,13495,64.83141904409041,35.1685809559096,11732,4073,7123,11196,63.62093604858878,36.37906395141122,1.9026488302170685,-3.327416552329032
WISCONSIN,WI,KENOSHA,55059,88738,42193,44972,87165,51.5941031377273,48.4058968622727,77076,35771,36025,71796,50.17689007744164,49.82310992255836,2.824433834178186,-2.844489359432767
WISCONSIN,WI,KEWAUNEE,55061,12095,3976,7927,11903,66.59665630513317,33.40334369486684,10758,3623,6616,10239,64.61568512550053,35.38431487449946,3.0657744722277114,-5.598444357785914
WISCONSIN,WI,LA CROSSE,55063,67884,37846,28684,66530,43.11438448820081,56.88561551179919,62968,32406,26389,58795,44.88306828811974,55.11693171188026,-3.9406481494650536,3.208966364754473
WISCONSIN,WI,LAFAYETTE,55065,8555,3647,4821,8468,56.931979215871515,43.068020784128485,7662,3288,3977,7265,54.741913282863045,45.258086717136955,4.000711341037588,-4.839059915847487
WISCONSIN,WI,LANGLADE,55067,11165,3704,7330,11034,66.43103135762189,33.5689686423781,10132,3260,6436,9696,66.37788778877888,33.62211221122112,0.08006215716311882,-0.15806136303739837
WISCONSIN,WI,LINCOLN,55069,16497,6261,10017,16278,61.53704386288242,38.46295613711758,14706,5370,8400,13770,61.00217864923747,38.99782135076253,0.8767969037965395,-1.3715258830336974
WISCONSIN,WI,MANITOWOC,55071,44829,16818,27218,44036,61.80852030157144,38.19147969842856,40346,14506,23193,37699,61.52152576991432,38.47847423008568,0.46649449613855865,-0.7458573589509077
WISCONSIN,WI,MARATHON,55073,76751,30808,44624,75432,59.15791706437586,40.84208293562414,69515,26477,39013,65490,59.57092685906245,40.42907314093755,-0.6933076526805193,1.0215663199767855
WISCONSIN,WI,MARINETTE,55075,22979,7366,15304,22670,67.50771945302161,32.492280546978385,20046,6243,12995,19238,67.54860172575111,32.45139827424888,-0.060522752040803596,0.1259800036473191
WISCONSIN,WI,MARQUETTE,55077,9065,3239,5719,8958,63.84237553025229,36.15762446974771,7893,2809,4714,7523,62.661172404625816,37.338827595374184,1.8850638765566252,-3.163471382729788
WISCONSIN,WI,MENOMINEE,55078,1590,1303,278,1581,17.58380771663504,82.41619228336496,1279,1003,269,1272,21.147798742138363,78.85220125786164,-16.85277540684099,4.519837073220567
WISCONSIN,WI,MILWAUKEE,55079,458971,317270,134357,451627,29.749549960476234,70.25045003952377,440247,288797,125846,414643,30.350446046357952,69.64955395364206,-1.9798591591171255,0.8627421882438258
WISCONSIN,WI,MONROE,55081,22611,8433,13775,22208,62.02719740634006,37.97280259365994,19670,7048,11352,18400,61.69565217391305,38.30434782608695,0.537388325991639,-0.8655550903315823
WISCONSIN,WI,OCONTO,55083,23215,6715,16226,22941,70.72926201996425,29.270737980035744,19978,5884,13253,19137,69.25327898834718,30.74672101165282,2.1312825229047094,-4.800456709050982
WISCONSIN,WI,ONEIDA,55085,24159,10105,13671,23776,57.49915881561238,42.50084118438762,21473,8104,12117,20221,59.92285248009495,40.07714751990505,-4.044690070933566,6.047570284982973
WISCONSIN,WI,OUTAGAMIE,55087,108022,47667,58385,106052,55.05318145815261,44.94681854184739,93868,38087,49884,87971,56.705050528014915,43.294949471985085,-2.9130898473429756,3.8153851430897
WISCONSIN,WI,OZAUKEE,55089,61486,26517,33912,60429,56.11875093084446,43.88124906915554,54523,20168,30430,50598,60.140717024388316,39.859282975611684,-6.6875925205761355,10.090412554597972
WISCONSIN,WI,PEPIN,55091,4144,1489,2584,4073,63.44218021114658,36.55781978885342,3739,1345,2206,3551,62.1233455364686,37.8766544635314,2.1229292519408416,-3.481919650395171
WISCONSIN,WI,PIERCE,55093,23317,9796,12815,22611,56.67595418159303,43.32404581840697,21189,8382,11258,19640,57.32179226069246,42.67820773930754,-1.1266885657765902,1.513273666608561
WISCONSIN,WI,POLK,55095,26371,9370,16611,25981,63.935183403256225,36.064816596743775,22749,7570,13815,21385,64.60135609071779,35.39864390928221,-1.031205423189685,1.8819158416599313
WISCONSIN,WI,PORTAGE,55097,40603,20428,19299,39727,48.57905203010547,51.42094796989453,38496,18521,17306,35827,48.30435146677087,51.69564853322913,0.5686869919443449,-0.531380437481177
WISCONSIN,WI,PRICE,55099,8546,3032,5394,8426,64.016140517446,35.983859482554,7577,2669,4562,7231,63.08947586779146,36.91052413220854,1.4688101888759464,-2.51057028162307
WISCONSIN,WI,RACINE,55101,106451,50159,54479,104638,52.06425963799002,47.93574036200998,94133,42512,46611,89123,52.29963084725604,47.70036915274396,-0.45004372966500616,0.4934368715519222
WISCONSIN,WI,RICHLAND,55103,9014,3995,4871,8866,54.940221069253326,45.059778930746674,8055,3577,4023,7600,52.93421052631579,47.06578947368421,3.7896296610304026,-4.262141494639449
WISCONSIN,WI,ROCK,55105,85360,46658,37138,83796,44.31953792543797,55.68046207456203,76068,39343,31488,70831,44.45511146249523,55.54488853750477,-0.3049672638244072,0.24407923145928212
WISCONSIN,WI,RUSK,55107,7886,2517,5257,7774,67.62284538204271,32.377154617957295,7087,2171,4564,6735,67.76540460282108,32.234595397178914,-0.2103716809689571,0.4422553440545318
WISCONSIN,WI,SAUK,55111,36203,18108,17493,35601,49.13626021740962,50.86373978259038,31318,14692,14791,29483,50.167893362276565,49.832106637723435,-2.056361301474685,2.07021780629677
WISCONSIN,WI,SAWYER,55113,10510,4498,5909,10407,56.7790909964447,43.2209090035553,9121,3504,5185,8689,59.67314995971918,40.32685004028082,-4.8498511729782035,7.176506373256841
WISCONSIN,WI,SHAWANO,55115,22615,7131,15173,22304,68.02815638450502,31.97184361549498,19751,6056,12742,18798,67.78380678795617,32.216193212043834,0.36048373221828633,-0.7584682489969241
WISCONSIN,WI,SHEBOYGAN,55117,66011,27101,37609,64710,58.11930149899552,41.88069850100448,59655,22956,32458,55414,58.57364564911394,41.42635435088606,-0.7756801631234933,1.0967514695357394
WISCONSIN,WI,ST. CROIX,55109,56707,23190,32199,55389,58.132481178573364,41.867518821426636,47508,17486,26220,43706,59.99176314464833,40.00823685535167,-3.0992287417724085,4.647247947459254
WISCONSIN,WI,TAYLOR,55119,10686,2693,7657,10350,73.98067632850241,26.019323671497585,9484,2398,6589,8987,73.3170134638923,26.682986536107713,0.905196261079233,-2.487213579754466
WISCONSIN,WI,TREMPEALEAU,55121,15380,6285,8833,15118,58.42704061383781,41.57295938616219,13675,5636,7364,13000,56.646153846153844,43.353846153846156,3.143879410631656,-4.10779417670184
WISCONSIN,WI,VERNON,55123,15923,7457,8218,15675,52.4274322169059,47.5725677830941,14213,6352,6996,13348,52.412346418939165,47.587653581060835,0.02878290898513658,-0.031701075450241145
WISCONSIN,WI,VILAS,55125,15369,5903,9261,15164,61.07227644420997,38.92772355579003,13612,4770,8169,12939,63.13470901924415,36.86529098075585,-3.2667174792957776,5.594510500705918
WISCONSIN,WI,WALWORTH,55127,57600,22789,33851,56640,59.76518361581921,40.23481638418079,51324,18706,28851,47557,60.66614799083205,39.33385200916795,-1.485118809832786,2.2905571892700483
WISCONSIN,WI,WASHBURN,55129,10378,3867,6334,10201,62.09195176943437,37.90804823056563,9148,3284,5404,8688,62.20073664825046,37.79926335174954,-0.1748932322639174,0.2877962932869238
WISCONSIN,WI,WASHINGTON,55131,88070,26650,60237,86887,69.32797771818569,30.67202228181431,78003,20855,51729,72584,71.26777251184834,28.732227488151658,-2.7218400762282102,6.7512857973248686
WISCONSIN,WI,WAUKESHA,55133,267996,103906,159649,263555,60.575212005084325,39.424787994915675,239042,79200,142521,221721,64.27943225946122,35.72056774053878,-5.762683527485068,10.369992664402773
WISCONSIN,WI,WAUPACA,55135,29130,9703,18952,28655,66.13854475658698,33.86145524341302,26024,8440,16189,24629,65.7314547890698,34.268545210930206,0.6193229235889053,-1.1879406172963014
WISCONSIN,WI,WAUSHARA,55137,13568,4388,9016,13404,67.2635034318114,32.7364965681886,11999,3792,7669,11461,66.91388186022162,33.08611813977838,0.522494827486053,-1.056701696200013
WISCONSIN,WI,WINNEBAGO,55139,94032,44060,47796,91856,52.03361783661383,47.96638216338617,87144,37054,43448,80502,53.97132990484708,46.02867009515292,-3.5902618513375395,4.209793731227762
WISCONSIN,WI,WOOD,55141,41298,16365,24308,40673,59.76446291151378,40.23553708848622,37800,14232,21503,35735,60.173499370365185,39.826500629634815,-0.6797617940312972,1.027045942738547
WYOMING,WY,ALBANY,56001,18744,9092,8579,17671,48.54846924339313,51.45153075660687,17060,6890,7602,14492,52.45652773944245,47.54347226055755,-7.4500899401140135,8.219968610268037
WYOMING,WY,BIG HORN,56003,5784,788,4806,5594,85.91347872720772,14.086521272792277,5317,604,4067,4671,87.06915007493042,12.930849925069579,-1.3273028928479813,8.93731931326609
WYOMING,WY,CAMPBELL,56005,19735,1935,16975,18910,89.76731887890006,10.232681121099947,18199,1324,15778,17102,92.25821541340194,7.741784586598059,-2.699918401131396,32.17470735124719
WYOMING,WY,CARBON,56007,6706,1427,5014,6441,77.84505511566528,22.154944884334732,6374,1279,4409,5688,77.514064697609,22.485935302391,0.4270069171930402,-1.4719886613792421
WYOMING,WY,CONVERSE,56009,7010,861,5917,6778,87.2971377987607,12.702862201239304,6654,668,5520,6188,89.2049127343245,10.795087265675502,-2.138643351679126,17.672621708486247
WYOMING,WY,CROOK,56011,4143,378,3651,4029,90.61801935964259,9.381980640357408,3826,273,3348,3621,92.46064623032312,7.539353769676885,-1.992876911210939,24.44011684518013
WYOMING,WY,FREMONT,56013,18234,5519,12007,17526,68.50964281638709,31.490357183612918,17023,4200,11167,15367,72.66870566798985,27.331294332010152,-5.723320394070008,15.217218771566587
WYOMING,WY,GOSHEN,56015,6272,1203,4878,6081,80.21706956092748,19.782930439072523,5796,924,4418,5342,82.7031074503931,17.296892549606888,-3.0059788151935996,14.372742863122756
WYOMING,WY,HOT SPRINGS,56017,2588,482,1999,2481,80.57234985892785,19.42765014107215,2586,400,1939,2339,82.89867464728516,17.101325352714834,-2.8062267560431953,13.603184199919394
WYOMING,WY,JOHNSON,56019,4952,897,3881,4778,81.22645458350775,18.773545416492258,4417,638,3477,4115,84.49574726609964,15.504252733900364,-3.8691801521040126,21.086425374397557
WYOMING,WY,LARAMIE,56021,45237,15217,27891,43108,64.7002876496242,35.2997123503758,40969,11573,24847,36420,68.22350356946733,31.776496430532674,-5.164226015240736,11.087490175467597
WYOMING,WY,LINCOLN,56023,10525,1509,8643,10152,85.13593380614657,14.864066193853429,8875,1105,6779,7884,85.98427194317605,14.015728056823948,-0.9866201316330536,6.052758255511703
WYOMING,WY,"NATRONA",56025,35391,8530,25271,33801,74.76406023490429,25.235939765095708,33348,6577,23552,30129,78.17053337316207,21.82946662683793,-4.35774580428705,15.604930695236208
WYOMING,WY,NIOBRARA,56027,1322,155,1118,1273,87.82403770620581,12.175962293794187,1314,115,1116,1231,90.65800162469537,9.34199837530463,-3.125994250591979,30.335735510092565
WYOMING,WY,PARK,56029,16815,3410,12813,16223,78.98045984096653,21.019540159033472,15095,2535,11115,13650,81.42857142857143,18.571428571428573,-3.0064528268832102,13.182139317872533
WYOMING,WY,PLATTE,56031,4963,890,3898,4788,81.41186299081036,18.58813700918964,4529,719,3437,4156,82.69971126082771,17.30028873917228,-1.5572584841990422,7.44408541055932
WYOMING,WY,SHERIDAN,56033,16546,4043,11843,15886,74.54991816693945,25.450081833060555,14510,2927,10266,13193,77.8139922686273,22.186007731372698,-4.19471358109954,14.712309403337166
WYOMING,WY,SUBLETTE,56035,5000,882,3957,4839,81.77309361438314,18.226906385616864,4390,644,3409,4053,84.1105354058722,15.889464594127807,-2.779011904049611,14.710639100784384
WYOMING,WY,SWEETWATER,56037,16698,3823,12229,16052,76.18365312733616,23.816346872663843,17130,3231,12154,15385,78.99902502437439,21.00097497562561,-3.5638058775656734,13.40591044132875
WYOMING,WY,TETON,56039,14787,9848,4341,14189,30.594122207343716,69.40587779265628,12627,7314,3921,11235,34.89986648865153,65.10013351134846,-12.337423361513222,6.614032950573345
WYOMING,WY,UINTA,56041,9459,1591,7496,9087,82.49147133267304,17.50852866732695,8470,1202,6154,7356,83.65959760739533,16.340402392604677,-1.3962848353683999,7.148699564772909
WYOMING,WY,WASHAKIE,56043,4032,651,3245,3896,83.2905544147844,16.709445585215605,3814,532,2911,3443,84.54835898925356,15.451641010746442,-1.4876747337331908,8.140265319355876
WYOMING,WY,WESTON,56045,3560,360,3107,3467,89.6163830400923,10.383616959907702,3526,299,3033,3332,91.02641056422569,8.97358943577431,-1.5490312266443929,15.713082643519938
